gameId,blueWins,blueWardsPlaced,blueWardsDestroyed,blueFirstBlood,blueKills,blueDeaths,blueAssists,blueEliteMonsters,blueDragons,blueHeralds,blueTowersDestroyed,blueTotalGold,blueAvgLevel,blueTotalExperience,blueTotalMinionsKilled,blueTotalJungleMinionsKilled,blueGoldDiff,blueExperienceDiff,blueCSPerMin,blueGoldPerMin,redWardsPlaced,redWardsDestroyed,redFirstBlood,redKills,redDeaths,redAssists,redEliteMonsters,redDragons,redHeralds,redTowersDestroyed,redTotalGold,redAvgLevel,redTotalExperience,redTotalMinionsKilled,redTotalJungleMinionsKilled,redGoldDiff,redExperienceDiff,redCSPerMin,redGoldPerMin
4519205334,0,14,2,0,4,8,3,2,1,1,0,14885,6.8,17810,192,59,-4790,-2126,19.2,1488.5,89,2,1,8,4,5,0,0,0,1,19675,7.4,19936,232,67,4790,2126,23.2,1967.5
4501108199,1,15,1,1,10,5,10,0,0,0,0,17878,7.0,18248,214,52,2301,603,21.4,1787.8,37,1,0,5,10,5,0,0,0,0,15577,6.8,17645,203,44,-2301,-603,20.3,1557.7
4526718235,1,10,5,0,16,13,16,2,1,1,0,19437,7.0,18500,188,32,546,680,18.8,1943.7,15,1,1,13,16,10,0,0,0,0,18891,7.0,17820,191,52,-546,-680,19.1,1889.1
4524404839,1,81,5,0,11,11,14,0,0,0,0,18913,7.0,18431,215,31,1441,922,21.5,1891.3,16,2,1,11,11,11,1,1,0,0,17472,7.0,17509,200,24,-1441,-922,20.0,1747.2
4510888904,0,18,2,0,8,13,5,0,0,0,0,16077,6.8,16712,180,48,-3056,-2462,18.0,1607.7,17,4,1,13,8,12,0,0,0,0,19133,7.2,19174,223,38,3056,2462,22.3,1913.3
4450445125,0,13,3,0,0,5,0,1,0,1,0,14103,6.6,17162,230,66,-1977,-700,23.0,1410.3,13,3,1,5,0,4,0,0,0,0,16080,7.0,17862,224,54,1977,700,22.4,1608.0
4519863866,1,81,3,0,16,7,12,1,1,0,0,21285,7.4,20332,229,60,5154,3837,22.9,2128.5,12,0,1,7,16,6,0,0,0,0,16131,6.8,16495,174,52,-5154,-3837,17.4,1613.1
4464937851,0,17,1,0,7,7,7,1,1,0,0,16645,6.8,18070,231,44,-742,-750,23.1,1664.5,13,0,1,7,7,5,0,0,0,0,17387,7.0,18820,223,72,742,750,22.3,1738.7
4469425272,1,34,1,1,3,2,6,1,1,0,0,16426,7.0,18180,236,64,2063,708,23.6,1642.6,14,2,0,2,3,6,0,0,0,0,14363,6.6,17472,210,40,-2063,-708,21.0,1436.3
4526079366,1,38,2,1,7,6,6,0,0,0,0,17232,7.2,18525,238,54,672,411,23.8,1723.2,16,2,0,6,7,13,1,1,0,0,16560,7.0,18114,210,52,-672,-411,21.0,1656.0
4521129958,1,13,3,1,6,3,5,0,0,0,0,16097,7.0,18426,226,51,1212,1738,22.6,1609.7,13,3,0,3,6,1,2,1,1,0,14885,6.6,16688,216,50,-1212,-1738,21.6,1488.5
4524250490,1,16,3,0,6,4,1,0,0,0,0,16327,7.0,18521,190,59,1570,1320,19.0,1632.7,16,1,1,4,6,1,1,1,0,0,14757,6.8,17201,214,56,-1570,-1320,21.4,1475.7
4498209224,0,17,4,1,7,7,15,0,0,0,0,17045,7.0,17969,214,48,-883,-1495,21.4,1704.5,20,3,0,7,7,7,0,0,0,0,17928,7.2,19464,250,52,883,1495,25.0,1792.8
4451962379,0,82,3,0,2,10,1,0,0,0,0,14675,6.8,17184,207,44,-3911,-2728,20.7,1467.5,15,1,1,10,2,10,2,1,1,0,18586,7.4,19912,254,40,3911,2728,25.4,1858.6
4427502264,1,17,1,0,9,3,9,1,1,0,1,18695,7.2,19263,245,56,4298,2299,24.5,1869.5,13,2,1,3,9,2,1,0,1,0,14397,6.8,16964,190,56,-4298,-2299,19.0,1439.7
4502535933,1,76,1,1,1,1,1,0,0,0,0,15082,6.8,17854,239,51,1389,894,23.9,1508.2,15,2,0,1,1,0,1,1,0,0,13693,6.4,16960,209,56,-1389,-894,20.9,1369.3
4509228650,1,16,1,1,9,3,6,1,1,0,0,18558,7.2,19625,269,51,3958,3881,26.9,1855.8,12,1,0,3,9,4,1,0,1,0,14600,6.4,15744,194,43,-3958,-3881,19.4,1460.0
4459817582,1,19,5,1,11,6,12,0,0,0,0,18354,6.8,17746,207,39,1775,-5,20.7,1835.4,37,5,0,6,11,3,0,0,0,0,16579,6.8,17751,208,54,-1775,5,20.8,1657.9
4527461215,0,11,3,1,8,7,10,0,0,0,0,17122,7.0,17535,204,51,312,-1396,20.4,1712.2,47,2,0,7,8,7,1,1,0,0,16810,7.0,18931,211,51,-312,1396,21.1,1681.0
4518443170,1,18,0,0,5,5,5,0,0,0,0,15238,6.8,17288,184,60,-719,825,18.4,1523.8,16,2,1,5,5,4,0,0,0,0,15957,6.8,16463,211,44,719,-825,21.1,1595.7
4438293749,1,14,1,0,4,7,4,0,0,0,0,15381,7.2,18597,222,56,-758,313,22.2,1538.1,15,1,1,7,4,5,0,0,0,0,16139,7.2,18284,194,51,758,-313,19.4,1613.9
4515573943,0,14,2,0,7,10,3,0,0,0,0,16418,6.8,17424,199,52,-1517,-62,19.9,1641.8,19,5,1,10,7,14,1,1,0,0,17935,6.8,17486,211,48,1517,62,21.1,1793.5
4524354626,0,22,1,1,9,3,16,1,0,1,0,18741,7.2,19102,243,44,3447,1976,24.3,1874.1,15,3,0,3,9,6,1,1,0,0,15294,6.8,17126,210,68,-3447,-1976,21.0,1529.4
4513226809,0,93,4,1,7,4,6,0,0,0,0,17129,6.8,17586,228,36,1440,247,22.8,1712.9,15,5,0,4,7,4,1,1,0,0,15689,7.0,17339,211,60,-1440,-247,21.1,1568.9
4508291469,0,17,0,0,7,8,8,0,0,0,0,16228,6.6,16832,191,44,-1127,-1496,19.1,1622.8,35,1,1,8,7,6,2,1,1,0,17355,7.0,18328,204,53,1127,1496,20.4,1735.5
4520601496,1,16,1,0,8,6,10,0,0,0,0,18029,7.2,18791,199,53,2323,1699,19.9,1802.9,15,2,1,6,8,5,0,0,0,0,15706,6.8,17092,192,38,-2323,-1699,19.2,1570.6
4450369263,1,18,2,1,2,4,2,1,1,0,0,14922,7.2,18119,227,65,-1316,-1111,22.7,1492.2,22,2,0,4,2,1,0,0,0,0,16238,6.8,19230,247,65,1316,1111,24.7,1623.8
4506208717,0,83,3,1,10,7,12,0,0,0,0,18592,7.2,19027,212,47,1577,678,21.2,1859.2,15,2,0,7,10,4,2,1,1,0,17015,7.0,18349,233,44,-1577,-678,23.3,1701.5
4518075871,0,23,7,0,7,6,6,0,0,0,0,16949,7.0,18440,236,61,16,560,23.6,1694.9,22,7,1,6,7,7,2,1,1,0,16933,7.2,17880,232,40,-16,-560,23.2,1693.3
4448358133,1,20,0,1,5,7,9,0,0,0,0,16072,6.8,16945,236,32,-184,408,23.6,1607.2,12,5,0,7,5,7,0,0,0,0,16256,6.8,16537,195,39,184,-408,19.5,1625.6
4521579265,1,17,1,0,3,4,4,0,0,0,0,15158,6.8,17197,236,47,-341,-1982,23.6,1515.8,18,3,1,4,3,5,2,1,1,0,15499,7.0,19179,219,56,341,1982,21.9,1549.9
4502539772,0,14,2,1,3,8,6,0,0,0,0,15193,6.8,17054,232,57,-1810,-2661,23.2,1519.3,16,0,0,8,3,2,1,1,0,0,17003,7.0,19715,235,65,1810,2661,23.5,1700.3
4474787155,1,12,2,0,7,2,7,1,0,1,0,17731,7.6,20617,238,80,3339,3179,23.8,1773.1,11,1,1,2,7,2,1,1,0,0,14392,6.8,17438,236,46,-3339,-3179,23.6,1439.2
4520755410,1,18,1,0,9,6,10,1,0,1,0,17512,7.0,18140,186,51,2549,1269,18.6,1751.2,17,0,1,6,9,6,1,1,0,0,14963,6.6,16871,174,41,-2549,-1269,17.4,1496.3
4511428769,1,13,0,0,9,6,10,1,0,1,0,17491,7.0,18181,194,74,616,43,19.4,1749.1,15,2,1,6,9,5,1,1,0,0,16875,6.8,18138,253,36,-616,-43,25.3,1687.5
4485854145,0,16,2,0,6,13,7,0,0,0,0,15522,6.8,16999,182,55,-3819,-2264,18.2,1552.2,14,4,1,13,6,16,1,1,0,0,19341,7.2,19263,220,40,3819,2264,22.0,1934.1
4500110259,1,18,3,1,6,2,4,0,0,0,0,16849,7.4,19849,241,67,2094,2789,24.1,1684.9,14,4,0,2,6,3,0,0,0,0,14755,6.8,17060,208,56,-2094,-2789,20.8,1475.5
4496624699,1,17,3,0,6,14,4,0,0,0,0,15786,6.6,16995,200,46,-4443,-4140,20.0,1578.6,16,3,1,14,6,9,1,1,0,0,20229,7.6,21135,227,66,4443,4140,22.7,2022.9
4499330396,1,15,0,1,3,4,1,0,0,0,0,14629,6.8,17474,184,57,-1623,-951,18.4,1462.9,14,3,0,4,3,7,2,1,1,0,16252,7.0,18425,243,65,1623,951,24.3,1625.2
4524429870,1,14,1,1,4,5,0,2,1,1,0,15464,7.0,17833,218,71,-736,-94,21.8,1546.4,25,2,0,5,4,9,0,0,0,0,16200,7.0,17927,223,60,736,94,22.3,1620.0
4508799879,0,10,3,0,3,6,5,1,0,1,0,15521,6.6,16916,202,60,-1187,-714,20.2,1552.1,72,1,1,6,3,6,1,1,0,0,16708,7.0,17630,219,53,1187,714,21.9,1670.8
4525192635,1,14,3,0,6,6,7,2,1,1,0,17074,7.2,17874,214,56,949,591,21.4,1707.4,50,3,1,6,6,6,0,0,0,0,16125,6.8,17283,225,48,-949,-591,22.5,1612.5
4513351199,0,16,4,0,5,8,3,1,1,0,0,15307,6.8,17610,227,56,-2576,-2182,22.7,1530.7,16,3,1,8,5,5,0,0,0,0,17883,7.4,19792,249,56,2576,2182,24.9,1788.3
4520943763,1,13,16,1,9,8,13,1,1,0,0,17060,6.8,17673,207,64,143,845,20.7,1706.0,39,3,0,8,9,7,0,0,0,0,16917,6.6,16828,212,48,-143,-845,21.2,1691.7
4508126925,1,16,3,1,16,7,22,2,1,1,0,21512,7.2,19190,218,35,5514,3051,21.8,2151.2,18,2,0,7,16,9,0,0,0,0,15998,6.4,16139,196,47,-5514,-3051,19.6,1599.8
4525352232,1,46,4,1,9,5,11,2,1,1,0,17498,7.0,18424,209,52,1885,1636,20.9,1749.8,17,3,0,5,9,3,0,0,0,0,15613,6.6,16788,200,60,-1885,-1636,20.0,1561.3
4524026578,0,14,1,0,4,5,4,0,0,0,0,15482,7.2,18715,237,47,-1335,-172,23.7,1548.2,39,2,1,5,4,5,2,1,1,0,16817,7.2,18887,228,55,1335,172,22.8,1681.7
4519431997,0,15,5,0,10,7,6,0,0,0,0,18269,7.2,19161,228,60,1974,861,22.8,1826.9,39,2,1,7,10,8,2,1,1,0,16295,7.0,18300,199,56,-1974,-861,19.9,1629.5
4526523308,0,22,1,0,5,5,2,0,0,0,0,15752,7.0,18629,217,55,-717,8,21.7,1575.2,94,2,1,5,5,4,0,0,0,0,16469,7.2,18621,218,54,717,-8,21.8,1646.9
4515418492,0,18,1,1,3,7,3,0,0,0,0,14951,6.8,17632,206,48,-2002,-565,20.6,1495.1,15,2,0,7,3,6,1,1,0,0,16953,7.0,18197,214,59,2002,565,21.4,1695.3
4518664448,0,13,5,1,7,9,9,0,0,0,0,15570,6.8,15894,198,36,-2365,-1443,19.8,1557.0,20,2,0,9,7,14,0,0,0,0,17935,6.8,17337,204,44,2365,1443,20.4,1793.5
4516268505,1,42,2,1,8,3,6,0,0,0,0,16532,7.2,18420,229,40,1558,785,22.9,1653.2,34,2,0,3,8,2,1,0,1,0,14974,7.0,17635,206,56,-1558,-785,20.6,1497.4
4497858921,0,15,2,1,5,4,4,0,0,0,0,15634,6.8,16355,201,45,71,-359,20.1,1563.4,14,1,0,4,5,4,1,1,0,0,15563,6.8,16714,222,38,-71,359,22.2,1556.3
4527031551,1,20,2,1,7,6,6,1,0,1,0,17131,6.6,17701,229,36,1254,-81,22.9,1713.1,13,2,0,6,7,3,1,1,0,0,15877,6.8,17782,199,62,-1254,81,19.9,1587.7
4498323673,0,18,4,1,11,11,16,0,0,0,0,18730,7.0,18011,208,38,175,-532,20.8,1873.0,18,4,0,11,11,14,1,1,0,0,18555,7.0,18543,219,81,-175,532,21.9,1855.5
4524922802,1,16,5,1,12,4,14,0,0,0,0,18338,7.0,18468,211,43,3054,2510,21.1,1833.8,18,0,0,4,12,2,1,1,0,0,15284,6.6,15958,190,61,-3054,-2510,19.0,1528.4
4508091967,0,17,1,0,2,8,1,0,0,0,0,14467,6.6,16928,215,48,-3794,-1962,21.5,1446.7,16,2,1,8,2,11,1,1,0,0,18261,7.2,18890,234,76,3794,1962,23.4,1826.1
4502625560,1,14,2,1,8,7,7,1,1,0,0,17472,7.2,18967,224,52,1177,763,22.4,1747.2,14,2,0,7,8,7,0,0,0,0,16295,7.2,18204,183,68,-1177,-763,18.3,1629.5
4473315873,1,11,2,1,12,3,10,1,1,0,0,19402,7.4,19955,242,44,5650,4520,24.2,1940.2,13,2,0,3,12,4,0,0,0,0,13752,6.4,15435,188,40,-5650,-4520,18.8,1375.2
4438426870,0,18,0,0,6,7,2,0,0,0,0,15141,6.8,17975,196,33,-770,196,19.6,1514.1,17,2,1,7,6,10,1,1,0,0,15911,6.8,17779,178,40,770,-196,17.8,1591.1
4464904147,0,17,1,1,5,5,3,1,0,1,0,16259,7.2,18538,242,58,-995,181,24.2,1625.9,16,4,0,5,5,5,0,0,0,0,17254,7.2,18357,256,42,995,-181,25.6,1725.4
4515468468,1,17,2,1,4,3,5,0,0,0,0,16668,7.2,18572,261,51,1401,85,26.1,1666.8,37,2,0,3,4,4,0,0,0,0,15267,7.2,18487,203,70,-1401,-85,20.3,1526.7
4520778338,1,14,3,1,5,3,7,1,0,1,1,17340,7.2,18431,215,51,2486,2148,21.5,1734.0,104,0,0,3,5,3,0,0,0,0,14854,6.6,16283,223,40,-2486,-2148,22.3,1485.4
4523615323,1,38,1,0,7,7,6,0,0,0,0,16639,6.8,18068,214,48,-293,-818,21.4,1663.9,15,4,1,7,7,5,1,1,0,0,16932,7.2,18886,232,52,293,818,23.2,1693.2
4524697889,0,25,4,1,5,3,4,1,0,1,0,16788,7.2,19474,264,59,1346,919,26.4,1678.8,39,3,0,3,5,6,1,1,0,0,15442,7.2,18555,242,56,-1346,-919,24.2,1544.2
4523456164,1,39,2,1,9,6,16,0,0,0,0,17335,6.8,17918,193,50,2094,2937,19.3,1733.5,15,1,0,6,9,14,0,0,0,0,15241,6.2,14981,170,33,-2094,-2937,17.0,1524.1
4524189570,1,17,4,1,5,2,6,2,1,1,0,16053,6.8,17406,218,51,1703,1696,21.8,1605.3,15,2,0,2,5,2,0,0,0,0,14350,6.4,15710,206,48,-1703,-1696,20.6,1435.0
4527875317,0,12,1,0,9,12,12,1,1,0,0,16198,7.0,18249,165,33,-2121,-1038,16.5,1619.8,13,3,1,12,9,7,1,0,1,0,18319,7.4,19287,187,68,2121,1038,18.7,1831.9
4512351336,1,60,8,0,5,8,9,0,0,0,0,15966,7.0,18157,209,47,-847,-267,20.9,1596.6,55,3,1,8,5,8,1,1,0,0,16813,7.2,18424,203,60,847,267,20.3,1681.3
4521497074,0,30,1,0,7,10,7,1,1,0,0,17088,7.0,18568,201,60,-793,606,20.1,1708.8,16,1,1,10,7,9,0,0,0,0,17881,7.0,17962,221,48,793,-606,22.1,1788.1
4515677158,0,38,5,1,5,4,6,0,0,0,0,16402,7.0,18713,250,43,1678,1857,25.0,1640.2,15,1,0,4,5,3,1,1,0,0,14724,6.6,16856,173,75,-1678,-1857,17.3,1472.4
4518093474,0,17,3,1,8,9,7,1,1,0,0,16527,6.6,16884,194,52,-233,-754,19.4,1652.7,39,6,0,9,8,12,1,0,1,0,16760,6.8,17638,197,38,233,754,19.7,1676.0
4464386796,0,14,1,0,5,10,2,1,0,1,0,15974,6.8,18618,226,60,-2545,-1541,22.6,1597.4,13,4,1,10,5,9,1,1,0,0,18519,7.6,20159,247,56,2545,1541,24.7,1851.9
4495628923,1,17,5,0,5,9,7,0,0,0,0,16103,6.6,17019,193,48,-2419,-1437,19.3,1610.3,50,5,1,9,5,14,1,0,1,0,18522,7.0,18456,246,40,2419,1437,24.6,1852.2
4525855407,1,13,3,0,6,10,5,1,1,0,0,15741,6.8,17468,198,43,-1864,-1069,19.8,1574.1,17,3,1,10,6,7,0,0,0,0,17605,7.2,18537,205,48,1864,1069,20.5,1760.5
4518116410,0,16,2,1,2,8,1,1,0,1,0,15157,6.8,16829,228,52,-1082,-1819,22.8,1515.7,16,4,0,8,2,4,1,1,0,0,16239,7.0,18648,229,40,1082,1819,22.9,1623.9
4518236753,0,18,1,1,4,12,7,0,0,0,0,15233,6.6,16168,208,39,-3184,-2345,20.8,1523.3,13,3,0,12,4,14,0,0,0,0,18417,7.0,18513,218,44,3184,2345,21.8,1841.7
4513621339,1,41,1,1,4,9,5,1,1,0,0,15316,6.6,17118,198,52,-2986,-3369,19.8,1531.6,13,9,0,9,4,3,0,0,0,0,18302,7.4,20487,247,64,2986,3369,24.7,1830.2
4379931850,0,18,2,0,3,6,3,1,0,1,0,15032,6.6,16832,213,48,-1683,-1363,21.3,1503.2,36,3,1,6,3,6,1,1,0,0,16715,7.0,18195,236,44,1683,1363,23.6,1671.5
4516194928,0,17,3,0,4,10,10,0,0,0,0,15928,6.8,17242,204,56,-2760,-1949,20.4,1592.8,12,3,1,10,4,13,1,1,0,0,18688,7.2,19191,233,55,2760,1949,23.3,1868.8
4515242299,1,13,3,0,4,10,1,0,0,0,0,16172,6.8,18087,219,69,-1867,555,21.9,1617.2,17,1,1,10,4,18,0,0,0,0,18039,6.8,17532,202,60,1867,-555,20.2,1803.9
4452176098,1,14,3,1,7,4,8,1,1,0,0,16866,6.8,17217,220,27,789,-1212,22.0,1686.6,12,1,0,4,7,5,0,0,0,0,16077,6.8,18429,224,52,-789,1212,22.4,1607.7
4497564028,1,20,6,0,13,2,13,1,0,1,0,19969,7.2,19752,255,55,6763,6488,25.5,1996.9,15,2,1,2,13,2,0,0,0,0,13206,5.8,13264,192,32,-6763,-6488,19.2,1320.6
4526718003,1,13,1,0,3,9,3,1,1,0,0,15431,6.8,17257,237,48,-2844,-2533,23.7,1543.1,36,2,1,9,3,11,0,0,0,0,18275,7.2,19790,221,44,2844,2533,22.1,1827.5
4522654087,0,12,0,0,3,8,3,0,0,0,0,15149,6.8,17143,205,51,-1876,-2659,20.5,1514.9,13,2,1,8,3,4,1,1,0,0,17025,7.4,19802,211,76,1876,2659,21.1,1702.5
4512554804,0,18,1,0,5,9,5,0,0,0,0,15463,6.6,16939,206,44,-2791,-2246,20.6,1546.3,17,2,1,9,5,13,1,1,0,0,18254,7.4,19185,227,57,2791,2246,22.7,1825.4
4507786946,1,16,2,1,7,6,7,2,1,1,0,17453,7.0,17851,237,49,1478,483,23.7,1745.3,36,2,0,6,7,8,0,0,0,0,15975,7.0,17368,199,62,-1478,-483,19.9,1597.5
4519181243,0,14,4,0,5,6,5,0,0,0,0,16449,6.8,17858,207,56,973,825,20.7,1644.9,12,2,1,6,5,8,0,0,0,0,15476,6.8,17033,192,52,-973,-825,19.2,1547.6
4498639695,0,16,2,0,3,7,5,0,0,0,0,14767,7.0,17485,212,68,-2150,-1486,21.2,1476.7,13,1,1,7,3,9,1,1,0,0,16917,7.2,18971,225,59,2150,1486,22.5,1691.7
4524920197,1,17,2,1,6,4,14,1,1,0,1,18529,7.0,18907,252,64,3048,472,25.2,1852.9,16,0,0,4,6,6,0,0,0,0,15481,7.0,18435,203,60,-3048,-472,20.3,1548.1
4469636302,0,13,1,1,5,7,5,0,0,0,0,15576,6.6,16352,221,35,-887,-1878,22.1,1557.6,14,2,0,7,5,7,1,0,1,0,16463,7.0,18230,197,68,887,1878,19.7,1646.3
4510513496,0,15,2,1,8,3,7,0,0,0,0,18103,7.4,19519,247,56,2683,1740,24.7,1810.3,58,3,0,3,8,3,1,1,0,0,15420,7.0,17779,241,52,-2683,-1740,24.1,1542.0
4484877784,0,18,5,0,3,8,2,1,1,0,0,14905,6.8,17974,233,52,-3282,-1647,23.3,1490.5,18,3,1,8,3,12,0,0,0,0,18187,7.4,19621,225,52,3282,1647,22.5,1818.7
4506715219,1,15,5,1,7,4,12,2,1,1,0,17915,7.0,18641,223,64,1110,-544,22.3,1791.5,13,2,0,4,7,6,0,0,0,0,16805,7.2,19185,235,72,-1110,544,23.5,1680.5
4526207203,1,24,4,1,8,5,6,0,0,0,0,17581,7.0,18639,243,45,1839,312,24.3,1758.1,122,1,0,5,8,2,1,1,0,0,15742,7.2,18327,221,45,-1839,-312,22.1,1574.2
4499622849,1,16,6,1,5,4,9,0,0,0,0,16415,6.8,17645,247,37,1626,747,24.7,1641.5,17,2,0,4,5,5,1,1,0,0,14789,7.0,16898,203,51,-1626,-747,20.3,1478.9
4493753428,1,17,4,0,5,5,7,1,0,1,0,17135,7.4,19139,242,52,1046,815,24.2,1713.5,19,3,1,5,5,6,1,1,0,0,16089,7.0,18324,233,48,-1046,-815,23.3,1608.9
4508363234,0,14,3,1,4,8,4,1,1,0,0,16250,6.8,17320,236,49,-1497,-1252,23.6,1625.0,17,3,0,8,4,13,0,0,0,0,17747,7.2,18572,225,64,1497,1252,22.5,1774.7
4485481619,0,14,1,0,3,4,0,0,0,0,0,15084,7.2,19173,224,68,-1302,1008,22.4,1508.4,14,1,1,4,3,5,1,1,0,0,16386,7.0,18165,226,60,1302,-1008,22.6,1638.6
4527457700,1,12,5,1,8,4,11,1,1,0,0,18320,7.0,18926,244,56,3461,1985,24.4,1832.0,20,3,0,4,8,2,0,0,0,0,14859,6.6,16941,217,36,-3461,-1985,21.7,1485.9
4508769864,0,50,4,0,5,2,7,2,1,1,0,16444,7.4,18995,229,63,1415,1951,22.9,1644.4,16,3,1,2,5,3,0,0,0,0,15029,6.8,17044,225,53,-1415,-1951,22.5,1502.9
4516975993,0,10,1,0,11,8,9,0,0,0,0,19627,7.4,20041,237,56,2760,3641,23.7,1962.7,13,2,1,8,11,11,1,1,0,0,16867,6.6,16400,167,52,-2760,-3641,16.7,1686.7
4523487666,0,9,2,1,6,5,6,1,0,1,0,16782,7.0,19622,238,61,817,350,23.8,1678.2,17,1,0,5,6,5,1,1,0,0,15965,7.2,19272,235,51,-817,-350,23.5,1596.5
4520727484,0,17,2,1,1,5,1,0,0,0,0,12713,6.0,14245,192,23,-2976,-2255,19.2,1271.3,14,1,0,5,1,8,2,1,1,0,15689,6.6,16500,237,44,2976,2255,23.7,1568.9
4424119688,1,14,1,1,5,8,3,0,0,0,0,15747,7.0,17856,214,52,-1358,-1063,21.4,1574.7,15,2,0,8,5,8,0,0,0,0,17105,7.0,18919,219,52,1358,1063,21.9,1710.5
4523403818,1,20,6,1,6,8,7,0,0,0,0,17053,7.0,18362,219,46,-298,0,21.9,1705.3,18,4,0,8,6,7,1,1,0,0,17351,7.2,18362,213,45,298,0,21.3,1735.1
4492594471,0,33,4,1,5,7,6,1,1,0,0,15534,7.0,17293,207,44,-1109,-1493,20.7,1553.4,87,1,0,7,5,4,0,0,0,0,16643,7.2,18786,223,47,1109,1493,22.3,1664.3
4494818670,1,13,7,1,6,5,8,1,1,0,0,16283,7.0,18397,228,44,-152,71,22.8,1628.3,19,1,0,5,6,8,0,0,0,0,16435,6.8,18326,253,40,152,-71,25.3,1643.5
4407377509,1,30,10,1,15,7,15,2,1,1,0,20822,6.8,18683,237,53,5040,2681,23.7,2082.2,20,4,0,7,15,8,0,0,0,0,15782,6.4,16002,187,26,-5040,-2681,18.7,1578.2
4465279641,0,16,2,1,8,13,4,0,0,0,0,17008,7.2,18223,217,55,-4178,-1302,21.7,1700.8,12,4,0,13,8,13,1,1,0,1,21186,7.4,19525,219,40,4178,1302,21.9,2118.6
4518673555,0,16,5,0,3,7,4,0,0,0,0,15396,6.6,16586,218,36,-1193,-843,21.8,1539.6,21,3,1,7,3,7,1,0,1,0,16589,6.8,17429,238,36,1193,843,23.8,1658.9
4486956653,1,24,5,1,7,7,8,0,0,0,0,16866,6.8,17575,194,54,-1543,-523,19.4,1686.6,16,1,0,7,7,7,1,0,1,1,18409,7.0,18098,207,48,1543,523,20.7,1840.9
4379951765,0,79,3,0,4,7,4,0,0,0,0,16017,6.6,17524,202,55,-1031,-570,20.2,1601.7,16,1,1,7,4,7,0,0,0,0,17048,7.0,18094,226,52,1031,570,22.6,1704.8
4523683062,0,13,5,0,5,6,5,0,0,0,0,15307,7.0,18407,218,39,-1259,-360,21.8,1530.7,20,6,1,6,5,12,0,0,0,0,16566,7.2,18767,250,47,1259,360,25.0,1656.6
4521099004,1,38,4,1,16,5,28,0,0,0,0,21089,7.0,18924,218,55,5859,3289,21.8,2108.9,22,3,0,5,16,7,0,0,0,0,15230,6.4,15635,205,41,-5859,-3289,20.5,1523.0
4513103851,0,17,2,1,7,7,8,1,1,0,0,17191,6.8,17267,206,48,-347,-2753,20.6,1719.1,14,1,0,7,7,11,0,0,0,0,17538,7.6,20020,212,68,347,2753,21.2,1753.8
4525793792,0,26,0,0,12,10,13,0,0,0,0,17513,6.8,17486,193,48,-773,-734,19.3,1751.3,15,4,1,10,12,11,1,1,0,0,18286,6.8,18220,208,54,773,734,20.8,1828.6
4526811185,1,14,3,0,7,5,7,0,0,0,0,16291,7.2,18127,227,39,473,1581,22.7,1629.1,16,1,1,5,7,7,0,0,0,0,15818,6.6,16546,220,32,-473,-1581,22.0,1581.8
4521670146,0,50,1,0,5,6,4,0,0,0,0,15620,7.0,17968,214,63,-1083,-127,21.4,1562.0,23,5,1,6,5,10,1,1,0,0,16703,7.0,18095,218,40,1083,127,21.8,1670.3
4515376019,0,18,2,1,8,6,5,2,1,1,0,16650,6.8,17551,233,37,907,-411,23.3,1665.0,11,6,0,6,8,3,0,0,0,0,15743,6.6,17962,195,66,-907,411,19.5,1574.3
4514370002,0,13,1,0,3,4,5,0,0,0,0,14751,6.8,17562,217,39,-982,36,21.7,1475.1,13,1,1,4,3,6,1,1,0,0,15733,6.8,17526,210,72,982,-36,21.0,1573.3
4525567739,1,15,1,0,4,3,5,0,0,0,0,15502,7.0,17716,223,56,243,-31,22.3,1550.2,17,2,1,3,4,5,1,1,0,0,15259,6.8,17747,214,49,-243,31,21.4,1525.9
4434774244,1,34,2,1,10,10,7,0,0,0,0,17838,7.0,18262,230,39,-482,668,23.0,1783.8,21,4,0,10,10,16,1,0,1,0,18320,6.8,17594,202,40,482,-668,20.2,1832.0
4507747871,1,18,1,1,6,5,6,0,0,0,0,16471,6.8,17952,246,36,1450,763,24.6,1647.1,18,2,0,5,6,3,0,0,0,0,15021,6.8,17189,200,40,-1450,-763,20.0,1502.1
4489696117,0,13,2,1,9,6,9,1,1,0,0,16738,6.8,16893,198,44,91,-1992,19.8,1673.8,14,1,0,6,9,5,0,0,0,0,16647,7.2,18885,224,55,-91,1992,22.4,1664.7
4510871194,0,38,3,0,4,9,4,0,0,0,0,15585,7.2,18357,216,55,-2017,-659,21.6,1558.5,12,3,1,9,4,12,0,0,0,0,17602,7.2,19016,220,49,2017,659,22.0,1760.2
4458803817,0,15,5,1,11,8,13,0,0,0,1,18723,6.8,17268,188,35,1844,-34,18.8,1872.3,19,0,0,8,11,6,1,1,0,0,16879,6.6,17302,210,40,-1844,34,21.0,1687.9
4434247820,1,15,2,0,10,10,7,0,0,0,0,17047,7.2,18719,202,40,-1518,-1106,20.2,1704.7,18,2,1,10,10,5,1,1,0,0,18565,7.4,19825,256,47,1518,1106,25.6,1856.5
4524990107,1,14,4,1,8,6,8,2,1,1,1,18250,7.0,17742,235,37,2518,860,23.5,1825.0,16,0,0,6,8,6,0,0,0,0,15732,6.6,16882,216,40,-2518,-860,21.6,1573.2
4442298197,0,18,2,1,9,6,13,1,1,0,0,17169,6.8,17934,216,33,-92,-1411,21.6,1716.9,14,0,0,6,9,6,1,0,1,0,17261,7.2,19345,221,63,92,1411,22.1,1726.1
4525232223,0,17,5,1,9,5,8,0,0,0,0,17757,7.0,18821,217,48,2341,2225,21.7,1775.7,18,3,0,5,9,5,1,1,0,0,15416,6.8,16596,185,58,-2341,-2225,18.5,1541.6
4496025643,1,18,1,0,10,7,9,0,0,0,0,18485,7.4,19949,228,52,2300,2148,22.8,1848.5,16,3,1,7,10,6,0,0,0,0,16185,7.2,17801,187,43,-2300,-2148,18.7,1618.5
4485937828,1,18,3,1,11,11,17,0,0,0,0,17571,6.8,16712,174,31,-3024,-2806,17.4,1757.1,18,2,0,11,11,9,1,0,1,1,20595,7.2,19518,243,51,3024,2806,24.3,2059.5
4437927077,0,198,1,1,6,9,6,0,0,0,0,16585,7.0,18342,231,55,-991,-844,23.1,1658.5,12,1,0,9,6,7,0,0,0,0,17576,7.4,19186,223,40,991,844,22.3,1757.6
4450170058,0,19,4,1,8,3,11,1,0,1,0,16565,6.8,17417,204,45,1217,309,20.4,1656.5,74,4,0,3,8,2,0,0,0,0,15348,6.6,17108,214,45,-1217,-309,21.4,1534.8
4448447768,0,10,1,0,10,15,8,0,0,0,0,17418,7.0,18495,202,38,-2298,-1255,20.2,1741.8,14,1,1,15,10,10,1,1,0,0,19716,7.2,19750,171,46,2298,1255,17.1,1971.6
4447392049,0,43,6,1,11,4,12,1,0,1,0,18976,7.4,20326,256,43,2856,1262,25.6,1897.6,16,0,0,4,11,6,1,1,0,0,16120,7.2,19064,210,72,-2856,-1262,21.0,1612.0
4522681859,0,20,3,0,7,6,6,0,0,0,0,17421,7.2,19606,241,59,1053,1304,24.1,1742.1,14,5,1,6,7,4,2,1,1,0,16368,7.2,18302,223,60,-1053,-1304,22.3,1636.8
4450484115,1,17,3,1,11,3,9,1,1,0,0,18583,7.2,18852,204,55,4280,2681,20.4,1858.3,17,1,0,3,11,2,0,0,0,0,14303,6.4,16171,202,48,-4280,-2681,20.2,1430.3
4523504461,1,14,2,1,13,7,12,1,1,0,0,19360,7.2,19057,238,52,3034,1636,23.8,1936.0,12,4,0,7,13,7,0,0,0,0,16326,6.6,17421,183,56,-3034,-1636,18.3,1632.6
4527448169,0,15,4,1,3,8,5,0,0,0,0,15259,6.6,17346,206,64,-2738,-1759,20.6,1525.9,20,4,0,8,3,10,1,1,0,0,17997,7.2,19105,251,56,2738,1759,25.1,1799.7
4527399718,0,15,0,0,1,6,1,0,0,0,0,14417,7.0,17488,237,61,-2984,-1466,23.7,1441.7,13,1,1,6,1,10,1,1,0,0,17401,7.0,18954,248,54,2984,1466,24.8,1740.1
4523305960,1,17,0,0,4,2,4,2,1,1,0,15752,7.2,19171,231,64,1064,2471,23.1,1575.2,54,2,1,2,4,4,0,0,0,0,14688,6.6,16700,235,44,-1064,-2471,23.5,1468.8
4500224763,0,8,1,0,1,5,2,0,0,0,0,13444,6.4,16544,197,52,-3445,-2015,19.7,1344.4,14,0,1,5,1,5,0,0,0,0,16889,7.0,18559,246,53,3445,2015,24.6,1688.9
4442047258,1,16,4,1,4,5,1,1,1,0,0,15855,7.0,18078,238,56,145,972,23.8,1585.5,17,3,0,5,4,7,0,0,0,0,15710,6.6,17106,224,36,-145,-972,22.4,1571.0
4514495149,1,14,1,1,7,10,5,2,1,1,1,17637,6.8,17342,196,56,-430,-1028,19.6,1763.7,14,2,0,10,7,16,0,0,0,0,18067,7.2,18370,210,37,430,1028,21.0,1806.7
4462579984,0,21,3,1,10,8,7,0,0,0,0,17823,6.6,17275,237,36,828,-79,23.7,1782.3,17,1,0,8,10,5,1,1,0,0,16995,6.8,17354,200,47,-828,79,20.0,1699.5
4463551021,0,17,1,0,2,11,2,0,0,0,0,13714,6.6,16890,201,43,-5129,-3055,20.1,1371.4,13,1,1,11,2,12,1,0,1,0,18843,7.2,19945,250,38,5129,3055,25.0,1884.3
4510783393,1,18,2,1,5,2,5,1,1,0,0,15931,7.0,17840,231,49,393,111,23.1,1593.1,16,2,0,2,5,3,0,0,0,0,15538,6.8,17729,255,51,-393,-111,25.5,1553.8
4452084615,0,19,1,0,3,4,2,0,0,0,0,14317,6.8,17076,224,45,-2155,-1351,22.4,1431.7,20,2,1,4,3,4,1,0,1,0,16472,7.0,18427,239,52,2155,1351,23.9,1647.2
4481998895,1,15,1,0,9,4,12,1,1,0,0,18055,6.8,17444,212,50,3332,2911,21.2,1805.5,14,0,1,4,9,8,0,0,0,0,14723,6.2,14533,186,41,-3332,-2911,18.6,1472.3
4525208394,0,17,3,0,5,3,5,1,0,1,0,16176,7.2,18728,221,60,543,1065,22.1,1617.6,10,4,1,3,5,4,0,0,0,0,15633,6.8,17663,257,51,-543,-1065,25.7,1563.3
4510792748,0,18,3,0,3,6,3,0,0,0,0,14649,6.6,15693,200,48,-1945,-2496,20.0,1464.9,13,3,1,6,3,7,1,1,0,0,16594,7.0,18189,216,61,1945,2496,21.6,1659.4
4494815274,1,12,0,1,12,6,12,0,0,0,0,18766,7.2,20059,231,45,2265,2656,23.1,1876.6,24,0,0,6,12,6,0,0,0,0,16501,6.8,17403,225,48,-2265,-2656,22.5,1650.1
4491591979,1,50,4,1,10,6,11,1,1,0,0,17592,6.8,17430,186,47,1417,1171,18.6,1759.2,15,1,0,6,10,11,0,0,0,0,16175,6.6,16259,220,32,-1417,-1171,22.0,1617.5
4526649785,1,14,1,0,7,6,7,1,1,0,0,16553,7.2,19304,205,56,1216,2889,20.5,1655.3,11,2,1,6,7,7,0,0,0,0,15337,6.6,16415,173,44,-1216,-2889,17.3,1533.7
4420577274,0,17,5,1,5,5,7,1,0,1,0,16242,7.0,18244,235,56,-598,-146,23.5,1624.2,24,2,0,5,5,11,1,1,0,0,16840,7.0,18390,229,59,598,146,22.9,1684.0
4493677959,0,19,2,1,5,7,7,0,0,0,0,15949,6.8,17005,209,51,-1568,-1850,20.9,1594.9,19,5,0,7,5,8,1,1,0,0,17517,7.2,18855,215,71,1568,1850,21.5,1751.7
4524055982,0,36,4,0,5,6,4,1,1,0,0,15954,7.0,18014,228,52,26,693,22.8,1595.4,15,2,1,6,5,4,0,0,0,0,15928,6.8,17321,190,44,-26,-693,19.0,1592.8
4524701312,1,16,2,1,6,5,5,2,1,1,0,16555,6.8,18782,224,57,-11,-176,22.4,1655.5,18,1,0,5,6,5,0,0,0,0,16566,7.4,18958,227,56,11,176,22.7,1656.6
4525378713,1,16,2,0,6,7,5,1,1,0,0,15391,6.6,16901,182,56,-1595,-907,18.2,1539.1,14,2,1,7,6,5,0,0,0,0,16986,6.8,17808,201,64,1595,907,20.1,1698.6
4514660539,1,20,2,1,9,9,7,0,0,0,0,17174,7.0,18159,189,49,-1342,-1278,18.9,1717.4,173,3,0,9,9,10,1,1,0,0,18516,7.2,19437,238,50,1342,1278,23.8,1851.6
4521100238,0,54,2,1,7,3,7,0,0,0,0,17576,7.2,18867,227,44,2237,1848,22.7,1757.6,14,1,0,3,7,4,0,0,0,0,15339,6.8,17019,209,60,-2237,-1848,20.9,1533.9
4472053682,0,12,4,0,3,8,2,0,0,0,0,15027,6.6,17054,211,56,-2037,110,21.1,1502.7,20,1,1,8,3,11,1,1,0,0,17064,6.6,16944,197,44,2037,-110,19.7,1706.4
4524523316,1,34,5,1,13,9,16,2,1,1,0,19694,7.2,19555,215,64,1910,1136,21.5,1969.4,13,5,0,9,13,13,0,0,0,0,17784,7.2,18419,212,44,-1910,-1136,21.2,1778.4
4455474376,0,89,2,0,8,6,5,0,0,0,0,17208,7.6,20217,218,54,931,740,21.8,1720.8,15,3,1,6,8,5,0,0,0,0,16277,7.2,19477,209,56,-931,-740,20.9,1627.7
4469904395,1,16,0,0,4,7,5,1,1,0,0,15524,7.0,17843,228,56,-629,-209,22.8,1552.4,24,1,1,7,4,7,0,0,0,0,16153,6.8,18052,192,55,629,209,19.2,1615.3
4500724554,0,17,4,0,3,13,3,0,0,0,0,14467,6.6,16331,209,44,-5563,-4698,20.9,1446.7,18,2,1,13,3,8,2,1,1,0,20030,7.6,21029,235,70,5563,4698,23.5,2003.0
4513293772,0,17,0,1,3,9,2,0,0,0,0,13820,5.8,13497,158,45,-3996,-2986,15.8,1382.0,90,1,0,9,3,14,1,1,0,0,17816,6.6,16483,190,48,3996,2986,19.0,1781.6
4516066047,1,18,5,1,5,1,3,1,1,0,0,16222,7.0,18746,241,60,1997,1560,24.1,1622.2,42,4,0,1,5,0,0,0,0,0,14225,7.0,17186,234,48,-1997,-1560,23.4,1422.5
4520326314,1,16,1,1,6,3,5,0,0,0,0,16298,7.0,19052,229,56,823,1225,22.9,1629.8,13,4,0,3,6,3,1,1,0,0,15475,6.8,17827,235,52,-823,-1225,23.5,1547.5
4499273242,1,36,3,1,17,7,24,1,0,1,0,20182,7.6,20589,199,44,3404,2667,19.9,2018.2,13,1,0,7,17,5,1,1,0,0,16778,7.0,17922,206,61,-3404,-2667,20.6,1677.8
4524316009,1,14,2,0,5,7,2,1,0,1,0,15493,6.8,17405,211,52,-860,-121,21.1,1549.3,17,0,1,7,5,10,1,1,0,0,16353,7.0,17526,202,46,860,121,20.2,1635.3
4524281918,0,104,2,0,9,8,8,0,0,0,0,17511,6.8,17230,216,39,225,787,21.6,1751.1,15,0,1,8,9,14,0,0,0,0,17286,6.6,16443,206,49,-225,-787,20.6,1728.6
4446010317,0,10,4,0,7,9,6,0,0,0,0,16317,6.6,16985,205,44,-2448,-1976,20.5,1631.7,18,4,1,9,7,7,1,1,0,1,18765,7.2,18961,238,42,2448,1976,23.8,1876.5
4519214985,1,17,3,0,8,7,14,0,0,0,0,17261,6.8,17685,219,44,-112,-198,21.9,1726.1,12,2,1,7,8,8,1,1,0,0,17373,7.0,17883,221,52,112,198,22.1,1737.3
4463456988,1,16,2,0,7,3,4,2,1,1,0,17071,7.2,19347,234,64,1738,2447,23.4,1707.1,16,3,1,3,7,2,0,0,0,0,15333,6.8,16900,226,57,-1738,-2447,22.6,1533.3
4527675281,0,17,3,0,3,2,6,2,1,1,0,15097,7.0,17461,226,40,-971,-1447,22.6,1509.7,38,2,1,2,3,2,0,0,0,0,16068,7.2,18908,253,57,971,1447,25.3,1606.8
4455128161,1,18,2,1,13,2,16,1,1,0,0,19773,7.6,20507,240,40,5622,3964,24.0,1977.3,13,3,0,2,13,4,0,0,0,0,14151,6.6,16543,203,64,-5622,-3964,20.3,1415.1
4507914365,1,20,4,1,11,6,15,1,0,1,0,19670,7.4,19683,239,52,3380,1666,23.9,1967.0,16,6,0,6,11,10,0,0,0,0,16290,7.0,18017,197,52,-3380,-1666,19.7,1629.0
4526620130,1,13,7,1,10,2,9,2,1,1,0,18137,7.0,18171,231,44,3807,1830,23.1,1813.7,14,4,0,2,10,3,0,0,0,0,14330,6.6,16341,204,43,-3807,-1830,20.4,1433.0
4513796211,0,14,0,0,8,12,5,0,0,0,0,16024,7.0,17294,212,46,-2370,-2104,21.2,1602.4,18,3,1,12,8,10,1,1,0,0,18394,7.4,19398,194,61,2370,2104,19.4,1839.4
4521182941,1,17,2,0,17,9,19,0,0,0,0,20619,7.4,18696,205,43,2828,1962,20.5,2061.9,17,2,1,9,17,7,1,1,0,0,17791,6.8,16734,198,38,-2828,-1962,19.8,1779.1
4458069984,0,23,3,1,3,6,3,1,0,1,1,16970,6.8,17789,252,64,381,108,25.2,1697.0,11,3,0,6,3,9,1,1,0,0,16589,7.0,17681,199,62,-381,-108,19.9,1658.9
4518702917,0,25,3,1,5,4,7,0,0,0,0,15694,7.0,18079,209,53,-451,591,20.9,1569.4,24,4,0,4,5,5,1,1,0,0,16145,7.0,17488,241,63,451,-591,24.1,1614.5
4509102299,1,15,0,0,10,4,12,0,0,0,0,18480,7.4,19565,232,64,2547,2189,23.2,1848.0,12,1,1,4,10,4,0,0,0,0,15933,6.6,17376,247,41,-2547,-2189,24.7,1593.3
4493017629,1,21,3,1,4,4,3,0,0,0,0,16297,6.8,17730,237,62,1772,1255,23.7,1629.7,17,1,0,4,4,4,0,0,0,0,14525,6.6,16475,202,36,-1772,-1255,20.2,1452.5
4450648028,0,11,2,0,6,6,10,1,1,0,0,17173,7.2,18789,232,54,386,-200,23.2,1717.3,18,2,1,6,6,8,0,0,0,0,16787,7.2,18989,202,55,-386,200,20.2,1678.7
4458640668,0,19,0,0,5,10,2,0,0,0,0,16451,7.0,18416,220,59,-977,143,22.0,1645.1,15,1,1,10,5,8,0,0,0,0,17428,6.8,18273,189,53,977,-143,18.9,1742.8
4438638752,1,22,6,1,7,4,5,1,1,0,0,17382,7.4,19669,218,75,2164,3151,21.8,1738.2,30,7,0,4,7,7,0,0,0,0,15218,6.6,16518,205,48,-2164,-3151,20.5,1521.8
4508690422,1,18,2,0,11,5,11,0,0,0,0,18403,7.4,19486,239,48,2239,1539,23.9,1840.3,22,4,1,5,11,4,1,1,0,0,16164,6.6,17947,231,63,-2239,-1539,23.1,1616.4
4520814737,0,15,3,0,4,3,4,1,0,1,0,16043,7.0,18432,237,48,711,1614,23.7,1604.3,13,2,1,3,4,5,1,1,0,0,15332,6.8,16818,209,48,-711,-1614,20.9,1533.2
4503781874,1,11,2,1,4,4,8,1,1,0,0,16341,7.4,19567,236,72,1567,1637,23.6,1634.1,14,0,0,4,4,3,1,0,1,0,14774,6.8,17930,203,55,-1567,-1637,20.3,1477.4
4518159499,0,38,2,0,6,8,8,0,0,0,0,16917,7.2,18964,212,62,-1013,-36,21.2,1691.7,12,1,1,8,6,6,1,1,0,0,17930,7.0,19000,260,56,1013,36,26.0,1793.0
4507963275,0,15,3,0,1,4,2,0,0,0,0,14996,6.8,17555,232,55,-844,-1002,23.2,1499.6,38,2,1,4,1,5,1,1,0,0,15840,7.2,18557,230,64,844,1002,23.0,1584.0
4456404061,0,41,4,1,6,5,5,1,0,1,0,15510,7.0,17367,202,33,-264,550,20.2,1551.0,16,5,0,5,6,6,1,1,0,0,15774,6.6,16817,202,51,264,-550,20.2,1577.4
4517486439,1,19,3,1,8,2,12,0,0,0,0,17432,7.2,18495,209,44,2673,1388,20.9,1743.2,11,2,0,2,8,4,1,1,0,0,14759,6.6,17107,216,64,-2673,-1388,21.6,1475.9
4501312404,1,16,3,1,6,4,5,0,0,0,0,15659,6.8,17407,211,47,-127,-445,21.1,1565.9,16,4,0,4,6,6,2,1,1,0,15786,6.8,17852,209,64,127,445,20.9,1578.6
4524927159,0,14,1,1,5,9,4,0,0,0,0,15463,7.0,17005,206,60,-3386,-2729,20.6,1546.3,16,3,0,9,5,13,0,0,0,0,18849,7.0,19734,234,51,3386,2729,23.4,1884.9
4497982653,1,18,0,0,5,5,6,0,0,0,0,15400,7.0,18242,197,56,-1255,-121,19.7,1540.0,14,3,1,5,5,8,1,1,0,0,16655,7.2,18363,250,48,1255,121,25.0,1665.5
4522663961,0,19,3,0,3,5,1,0,0,0,0,15143,7.2,19080,233,59,-927,967,23.3,1514.3,16,4,1,5,3,7,1,1,0,0,16070,7.0,18113,216,48,927,-967,21.6,1607.0
4489643108,0,17,2,1,9,8,10,1,0,1,0,18529,7.2,18459,227,57,1550,910,22.7,1852.9,19,2,0,8,9,11,1,1,0,0,16979,6.6,17549,206,51,-1550,-910,20.6,1697.9
4502985762,1,15,1,1,4,1,4,0,0,0,0,16008,7.2,19253,247,45,344,1298,24.7,1600.8,15,3,0,1,4,2,0,0,0,0,15664,7.0,17955,264,52,-344,-1298,26.4,1566.4
4518046236,1,13,1,0,6,3,6,1,1,0,0,16665,7.0,18534,236,56,1630,1924,23.6,1666.5,14,1,1,3,6,3,0,0,0,0,15035,6.8,16610,235,36,-1630,-1924,23.5,1503.5
4526073509,1,20,6,0,9,5,8,0,0,0,0,17562,6.6,17442,203,50,1975,812,20.3,1756.2,19,3,1,5,9,5,1,1,0,0,15587,6.6,16630,208,42,-1975,-812,20.8,1558.7
4511966451,0,13,2,0,2,5,3,0,0,0,0,15123,6.8,17214,232,60,-2105,-1094,23.2,1512.3,15,2,1,5,2,6,1,1,0,0,17228,6.8,18308,234,48,2105,1094,23.4,1722.8
4469401946,0,13,7,1,11,10,20,1,0,1,0,17949,6.6,16183,172,41,-431,-1022,17.2,1794.9,45,1,0,10,11,10,1,1,0,0,18380,6.6,17205,207,48,431,1022,20.7,1838.0
4498660251,1,16,3,0,8,6,7,1,1,0,0,17104,7.0,18350,223,64,-111,1062,22.3,1710.4,36,2,1,6,8,8,1,0,1,1,17215,6.8,17288,201,48,111,-1062,20.1,1721.5
4469375094,1,80,5,0,5,10,3,0,0,0,0,16637,6.8,17846,219,40,-2368,618,21.9,1663.7,56,6,1,10,5,14,1,1,0,1,19005,7.0,17228,224,48,2368,-618,22.4,1900.5
4525129599,1,16,3,1,9,7,10,0,0,0,0,18064,7.2,19192,252,45,2321,1274,25.2,1806.4,18,2,0,7,9,5,1,1,0,0,15743,6.8,17918,198,41,-2321,-1274,19.8,1574.3
4497740999,1,22,6,0,8,4,12,1,1,0,0,18232,7.2,18215,228,52,2655,2106,22.8,1823.2,17,4,1,4,8,3,0,0,0,0,15577,6.4,16109,226,36,-2655,-2106,22.6,1557.7
4509854738,1,16,1,1,7,4,8,1,1,0,0,16351,6.8,17063,171,55,1487,1143,17.1,1635.1,15,0,0,4,7,2,0,0,0,0,14864,6.4,15920,224,28,-1487,-1143,22.4,1486.4
4526660217,0,12,4,1,6,5,10,0,0,0,0,16532,6.6,16932,213,58,1920,1140,21.3,1653.2,17,1,0,5,6,9,1,1,0,0,14612,6.4,15792,155,52,-1920,-1140,15.5,1461.2
4517836453,1,12,5,1,3,7,3,0,0,0,0,15159,6.6,17052,235,60,-1984,-1530,23.5,1515.9,18,2,0,7,3,16,1,1,0,0,17143,6.8,18582,238,47,1984,1530,23.8,1714.3
4471999593,0,15,4,0,6,3,3,0,0,0,0,15365,6.4,16848,186,44,-136,-385,18.6,1536.5,19,3,1,3,6,3,0,0,0,0,15501,6.6,17233,219,48,136,385,21.9,1550.1
4522251387,1,12,3,1,9,5,9,0,0,0,0,17309,7.0,18904,221,36,1425,728,22.1,1730.9,14,2,0,5,9,3,2,1,1,0,15884,6.8,18176,208,44,-1425,-728,20.8,1588.4
4491630754,1,17,6,0,7,8,8,0,0,0,0,15956,6.8,17011,191,51,-1206,-963,19.1,1595.6,19,5,1,8,7,7,1,1,0,0,17162,7.0,17974,243,44,1206,963,24.3,1716.2
4467269320,0,46,8,1,3,2,5,1,1,0,0,15570,7.2,18813,236,60,-61,-100,23.6,1557.0,24,8,0,2,3,2,0,0,0,0,15631,7.2,18913,260,60,61,100,26.0,1563.1
4496714478,1,17,4,0,6,9,4,1,1,0,0,17048,7.2,18842,201,64,-32,848,20.1,1704.8,14,2,1,9,6,9,0,0,0,0,17080,7.0,17994,197,48,32,-848,19.7,1708.0
4466034400,0,15,1,1,2,13,2,0,0,0,0,14712,6.2,15826,202,52,-4016,-3206,20.2,1471.2,17,2,0,13,2,17,1,1,0,0,18728,7.0,19032,253,48,4016,3206,25.3,1872.8
4465050280,0,143,5,1,10,7,10,1,1,0,0,17665,7.4,18125,213,37,625,-1035,21.3,1766.5,15,2,0,7,10,4,0,0,0,0,17040,7.2,19160,228,71,-625,1035,22.8,1704.0
4477116393,0,14,2,0,4,6,5,0,0,0,0,16414,6.8,18297,247,62,-58,-1047,24.7,1641.4,16,3,1,6,4,2,1,1,0,0,16472,7.0,19344,244,60,58,1047,24.4,1647.2
4450611631,0,18,1,1,9,5,6,1,1,0,0,17384,7.4,19286,235,56,2175,1409,23.5,1738.4,18,8,0,5,9,3,0,0,0,0,15209,7.2,17877,222,44,-2175,-1409,22.2,1520.9
4495708028,0,13,1,0,5,9,5,0,0,0,0,16841,6.8,17341,234,46,-1482,-724,23.4,1684.1,16,1,1,9,5,11,1,1,0,0,18323,7.0,18065,199,52,1482,724,19.9,1832.3
4483120111,0,42,1,0,6,6,5,0,0,0,0,15651,6.8,17769,195,44,-919,-483,19.5,1565.1,16,2,1,6,6,5,1,1,0,0,16570,7.0,18252,203,68,919,483,20.3,1657.0
4516576822,0,18,2,0,5,5,5,0,0,0,0,15364,6.8,17090,198,48,-799,-588,19.8,1536.4,14,3,1,5,5,6,0,0,0,0,16163,6.8,17678,242,44,799,588,24.2,1616.3
4527210467,0,42,4,0,1,6,3,1,1,0,0,14261,7.0,17724,198,67,-2160,85,19.8,1426.1,67,4,1,6,1,11,0,0,0,0,16421,6.8,17639,207,39,2160,-85,20.7,1642.1
4465418365,0,14,0,0,5,9,3,0,0,0,0,15905,6.8,17772,203,43,-1798,-1804,20.3,1590.5,14,4,1,9,5,5,1,1,0,0,17703,7.0,19576,218,58,1798,1804,21.8,1770.3
4524613194,1,11,3,1,12,3,16,1,1,0,0,18280,7.4,19206,209,43,4254,3059,20.9,1828.0,17,1,0,3,12,4,0,0,0,0,14026,6.6,16147,204,44,-4254,-3059,20.4,1402.6
4479650121,0,17,2,1,5,4,4,1,1,0,1,17457,7.0,18205,225,52,1495,-413,22.5,1745.7,15,1,0,4,5,3,0,0,0,0,15962,6.8,18618,248,53,-1495,413,24.8,1596.2
4520027447,1,14,3,1,8,5,5,1,1,0,0,16523,7.2,18718,193,56,1357,614,19.3,1652.3,17,2,0,5,8,2,0,0,0,0,15166,6.8,18104,208,52,-1357,-614,20.8,1516.6
4497467264,1,15,4,1,8,3,8,1,1,0,0,17640,7.2,19566,233,56,2768,2761,23.3,1764.0,18,2,0,3,8,2,0,0,0,0,14872,6.6,16805,220,52,-2768,-2761,22.0,1487.2
4525085237,1,12,1,1,2,5,1,1,1,0,0,14936,7.2,17688,231,53,-1543,-509,23.1,1493.6,14,2,0,5,2,8,0,0,0,0,16479,7.0,18197,250,40,1543,509,25.0,1647.9
4516124063,0,17,3,1,4,10,7,1,1,0,0,14719,6.6,16802,200,40,-2317,-1800,20.0,1471.9,16,2,0,10,4,10,1,0,1,0,17036,7.0,18602,194,45,2317,1800,19.4,1703.6
4492447049,0,13,2,1,1,4,1,0,0,0,0,14017,6.4,15893,229,32,-2638,-2478,22.9,1401.7,39,3,0,4,1,5,2,1,1,0,16655,6.8,18371,231,56,2638,2478,23.1,1665.5
4515302737,0,16,2,0,4,13,4,0,0,0,0,14958,6.8,16993,207,47,-4629,-3393,20.7,1495.8,55,4,1,13,4,16,1,1,0,0,19587,7.4,20386,239,46,4629,3393,23.9,1958.7
4491485082,0,24,3,1,3,2,5,1,0,1,0,14783,6.6,16564,205,54,401,95,20.5,1478.3,18,6,0,2,3,4,1,1,0,0,14382,6.8,16469,209,42,-401,-95,20.9,1438.2
4500406519,1,18,4,1,4,7,2,0,0,0,0,15950,6.8,17900,235,58,-365,-434,23.5,1595.0,16,2,0,7,4,7,0,0,0,0,16315,6.8,18334,225,37,365,434,22.5,1631.5
4459848079,0,16,4,0,2,9,2,0,0,0,0,13791,6.6,16220,199,50,-4379,-3811,19.9,1379.1,15,3,1,9,2,6,0,0,0,0,18170,7.4,20031,250,54,4379,3811,25.0,1817.0
4475476612,1,159,4,0,8,7,5,0,0,0,0,17321,7.6,19677,238,48,703,477,23.8,1732.1,15,1,1,7,8,6,1,1,0,0,16618,7.2,19200,212,68,-703,-477,21.2,1661.8
4477133738,0,14,3,0,7,9,5,0,0,0,0,16855,7.2,18568,221,59,-1297,-856,22.1,1685.5,79,1,1,9,7,8,1,1,0,0,18152,7.2,19424,229,51,1297,856,22.9,1815.2
4500599044,0,89,3,0,7,5,8,1,0,1,0,16269,7.2,18306,202,52,459,1388,20.2,1626.9,16,2,1,5,7,8,1,1,0,0,15810,6.6,16918,212,44,-459,-1388,21.2,1581.0
4476455937,0,15,5,0,6,10,7,0,0,0,0,15530,7.0,18389,222,40,-1932,-930,22.2,1553.0,17,6,1,10,6,6,1,1,0,0,17462,7.4,19319,232,39,1932,930,23.2,1746.2
4520050863,0,11,5,0,7,15,5,0,0,0,0,15463,6.4,16063,208,20,-3882,-2253,20.8,1546.3,15,1,1,15,7,15,2,1,1,0,19345,7.0,18316,213,40,3882,2253,21.3,1934.5
4513442931,0,40,4,1,7,5,9,0,0,0,0,17003,6.6,18007,214,40,1331,1287,21.4,1700.3,16,1,0,5,7,8,0,0,0,0,15672,6.8,16720,190,52,-1331,-1287,19.0,1567.2
4524990772,0,15,0,1,7,8,8,0,0,0,0,16979,6.8,17700,228,34,1038,454,22.8,1697.9,10,3,0,8,7,4,1,1,0,0,15941,6.8,17246,174,56,-1038,-454,17.4,1594.1
4497961157,1,14,2,0,10,5,7,1,1,0,0,17687,6.8,18625,213,56,2159,2100,21.3,1768.7,15,2,1,5,10,5,0,0,0,0,15528,6.8,16525,180,52,-2159,-2100,18.0,1552.8
4459784621,0,11,1,0,5,9,4,0,0,0,0,15102,6.8,18032,174,68,-5691,-2006,17.4,1510.2,14,2,1,9,5,8,2,1,1,2,20793,7.4,20038,226,56,5691,2006,22.6,2079.3
4475412255,0,13,0,0,5,6,4,0,0,0,0,15882,6.6,17373,231,46,-764,-128,23.1,1588.2,9,2,1,6,5,6,1,1,0,0,16646,6.8,17501,225,43,764,128,22.5,1664.6
4513907463,0,16,1,1,6,3,5,1,0,1,0,15960,6.8,17046,180,44,664,185,18.0,1596.0,12,4,0,3,6,1,1,1,0,0,15296,6.6,16861,205,64,-664,-185,20.5,1529.6
4524047354,0,45,1,0,4,10,3,0,0,0,0,14396,6.6,16065,203,40,-4339,-2857,20.3,1439.6,18,2,1,10,4,4,0,0,0,0,18735,7.0,18922,234,56,4339,2857,23.4,1873.5
4504189660,0,15,3,1,2,4,3,0,0,0,0,14779,6.6,16944,214,64,-1024,-571,21.4,1477.9,16,1,0,4,2,5,1,1,0,0,15803,7.0,17515,227,52,1024,571,22.7,1580.3
4500135002,1,13,2,1,10,8,10,0,0,0,0,17692,7.2,18587,203,63,1018,1319,20.3,1769.2,12,1,0,8,10,10,1,1,0,0,16674,6.8,17268,201,38,-1018,-1319,20.1,1667.4
4454995485,0,32,3,0,7,8,7,0,0,0,0,16650,7.2,17869,212,53,-1213,-1099,21.2,1665.0,16,5,1,8,7,6,1,1,0,0,17863,7.2,18968,229,59,1213,1099,22.9,1786.3
4499940691,1,16,3,1,9,2,5,0,0,0,0,17139,7.2,19137,223,51,3037,2694,22.3,1713.9,14,2,0,2,9,2,1,1,0,0,14102,6.6,16443,213,41,-3037,-2694,21.3,1410.2
4522792360,0,30,6,1,5,5,7,1,0,1,0,16804,6.8,17544,217,67,769,480,21.7,1680.4,16,4,0,5,5,6,1,1,0,0,16035,6.4,17064,233,54,-769,-480,23.3,1603.5
4513313637,0,13,6,0,2,4,1,0,0,0,0,14155,6.6,16974,226,46,-1735,-1786,22.6,1415.5,17,3,1,4,2,3,1,1,0,0,15890,7.0,18760,258,59,1735,1786,25.8,1589.0
4467567796,0,18,1,1,9,8,10,2,1,1,0,17431,6.8,18061,178,60,253,-121,17.8,1743.1,13,2,0,8,9,6,0,0,0,0,17178,7.0,18182,224,56,-253,121,22.4,1717.8
4459961867,0,15,4,1,8,6,11,1,0,1,0,17662,7.2,19112,219,60,1016,310,21.9,1766.2,20,3,0,6,8,8,1,1,0,0,16646,7.2,18802,231,60,-1016,-310,23.1,1664.6
4515529388,1,14,2,0,7,5,6,1,1,0,0,15866,6.8,17452,176,59,394,-55,17.6,1586.6,14,2,1,5,7,4,0,0,0,0,15472,6.8,17507,216,45,-394,55,21.6,1547.2
4524640589,1,16,3,0,8,8,12,2,1,1,0,16367,6.6,16065,202,40,151,1281,20.2,1636.7,14,5,1,8,8,18,0,0,0,0,16216,6.2,14784,201,8,-151,-1281,20.1,1621.6
4524183803,1,15,1,0,9,8,9,0,0,0,0,16872,7.0,17906,199,36,-1232,-272,19.9,1687.2,17,1,1,8,9,6,1,1,0,0,18104,7.0,18178,225,48,1232,272,22.5,1810.4
4432850060,1,19,3,1,9,6,11,0,0,0,0,17561,7.0,19152,207,68,2134,1500,20.7,1756.1,15,4,0,6,9,2,1,1,0,0,15427,7.0,17652,204,48,-2134,-1500,20.4,1542.7
4525838366,0,16,6,0,2,7,1,0,0,0,0,14284,7.0,17853,243,40,-3304,-1505,24.3,1428.4,20,3,1,7,2,8,1,1,0,0,17588,7.2,19358,237,67,3304,1505,23.7,1758.8
4518530813,0,23,3,0,11,6,12,0,0,0,0,17944,7.0,17835,214,30,901,144,21.4,1794.4,21,7,1,6,11,5,0,0,0,0,17043,6.8,17691,230,53,-901,-144,23.0,1704.3
4522471195,0,18,8,1,4,4,4,0,0,0,0,15597,6.8,17541,232,36,717,215,23.2,1559.7,15,2,0,4,4,3,1,1,0,0,14880,6.8,17326,197,52,-717,-215,19.7,1488.0
4494166965,0,18,2,0,10,11,9,1,1,0,0,18445,7.0,18076,199,50,552,-193,19.9,1844.5,13,3,1,11,10,10,0,0,0,0,17893,7.0,18269,207,36,-552,193,20.7,1789.3
4523059751,1,15,3,0,4,4,3,0,0,0,0,16669,7.4,19026,266,51,565,275,26.6,1666.9,19,4,1,4,4,5,1,1,0,0,16104,7.2,18751,238,56,-565,-275,23.8,1610.4
4518193450,0,16,3,0,6,10,8,0,0,0,0,16837,7.2,17911,191,59,-2152,-2041,19.1,1683.7,16,4,1,10,6,8,2,1,1,0,18989,7.4,19952,237,56,2152,2041,23.7,1898.9
4523100745,1,12,0,1,8,9,5,0,0,0,0,17259,7.0,18116,214,46,240,399,21.4,1725.9,17,0,0,9,8,14,1,1,0,0,17019,6.8,17717,223,32,-240,-399,22.3,1701.9
4515771570,1,15,1,0,3,4,4,0,0,0,0,15022,7.0,18105,220,48,-1211,-108,22.0,1502.2,17,1,1,4,3,5,0,0,0,0,16233,6.8,18213,216,67,1211,108,21.6,1623.3
4510825805,1,18,2,1,8,2,13,1,1,0,0,17226,7.2,18501,224,52,3923,3613,22.4,1722.6,14,2,0,2,8,3,0,0,0,0,13303,6.0,14888,183,23,-3923,-3613,18.3,1330.3
4496746747,1,55,3,1,7,5,5,0,0,0,0,16812,7.0,19678,228,56,1322,2276,22.8,1681.2,17,4,0,5,7,5,1,1,0,0,15490,6.6,17402,215,64,-1322,-2276,21.5,1549.0
4526239268,0,9,0,0,2,11,4,1,1,0,0,14079,6.6,16131,215,51,-4780,-3425,21.5,1407.9,15,3,1,11,2,13,0,0,0,0,18859,7.4,19556,214,52,4780,3425,21.4,1885.9
4511710215,1,16,5,0,5,10,6,0,0,0,0,16413,6.8,18104,225,50,-3036,-2088,22.5,1641.3,16,3,1,10,5,8,1,1,0,0,19449,7.4,20192,251,69,3036,2088,25.1,1944.9
4457344340,0,19,2,0,5,6,4,1,0,1,0,16416,6.8,18647,253,44,-205,-41,25.3,1641.6,12,4,1,6,5,7,1,1,0,0,16621,7.0,18688,239,40,205,41,23.9,1662.1
4499960219,1,17,3,1,10,6,13,2,1,1,1,19263,7.4,19347,197,50,3840,3165,19.7,1926.3,21,3,0,6,10,8,0,0,0,0,15423,6.4,16182,204,38,-3840,-3165,20.4,1542.3
4505127174,1,18,2,1,6,2,5,1,1,0,0,16953,7.2,19642,248,52,2348,2678,24.8,1695.3,18,4,0,2,6,3,0,0,0,0,14605,6.6,16964,225,56,-2348,-2678,22.5,1460.5
4525014650,0,17,3,0,3,4,4,0,0,0,0,15179,6.8,17410,237,53,-657,-81,23.7,1517.9,65,1,1,4,3,4,2,1,1,0,15836,7.0,17491,237,52,657,81,23.7,1583.6
4502741131,0,17,1,1,10,7,13,0,0,0,0,18446,7.2,19075,195,44,1918,1638,19.5,1844.6,11,2,0,7,10,8,2,1,1,0,16528,7.0,17437,191,48,-1918,-1638,19.1,1652.8
4508345813,0,13,1,1,6,11,9,0,0,0,0,15377,6.4,15779,191,32,-4853,-3538,19.1,1537.7,16,1,0,11,6,7,0,0,0,1,20230,7.0,19317,230,59,4853,3538,23.0,2023.0
4524677634,1,19,1,1,7,4,11,0,0,0,0,16867,7.2,18904,219,57,920,1488,21.9,1686.7,18,2,0,4,7,6,1,1,0,0,15947,7.0,17416,210,54,-920,-1488,21.0,1594.7
4466982463,1,17,0,1,4,5,2,1,1,0,0,15557,6.8,17180,234,53,-633,-1323,23.4,1555.7,14,1,0,5,4,6,0,0,0,0,16190,7.0,18503,206,54,633,1323,20.6,1619.0
4518069605,1,77,2,0,4,3,7,1,1,0,0,16321,7.0,18950,250,52,508,-183,25.0,1632.1,15,4,1,3,4,7,0,0,0,0,15813,7.0,19133,225,74,-508,183,22.5,1581.3
4507115446,1,14,8,0,6,4,11,1,1,0,0,16538,7.2,18707,235,55,1585,1348,23.5,1653.8,14,3,1,4,6,4,0,0,0,0,14953,6.6,17359,189,44,-1585,-1348,18.9,1495.3
4473597829,0,19,4,1,4,5,5,0,0,0,0,15435,6.8,17093,231,38,-1077,-2560,23.1,1543.5,16,5,0,5,4,1,0,0,0,0,16512,7.4,19653,249,75,1077,2560,24.9,1651.2
4491740882,0,13,3,0,2,9,2,0,0,0,0,14663,6.4,15958,228,44,-3148,-2856,22.8,1466.3,17,2,1,9,2,13,1,1,0,0,17811,7.2,18814,215,64,3148,2856,21.5,1781.1
4476300394,1,16,7,1,6,2,6,1,0,1,0,16399,7.4,18784,235,62,2036,2773,23.5,1639.9,177,2,0,2,6,2,1,1,0,0,14363,6.6,16011,221,48,-2036,-2773,22.1,1436.3
4517940231,1,18,4,0,7,4,16,1,1,0,1,18539,7.0,18188,253,53,3466,1525,25.3,1853.9,25,2,1,4,7,2,1,0,1,0,15073,6.6,16663,222,42,-3466,-1525,22.2,1507.3
4524598212,1,16,2,1,11,6,8,1,0,1,0,18045,7.4,20275,227,55,2647,3204,22.7,1804.5,15,6,0,6,11,10,0,0,0,0,15398,6.6,17071,203,35,-2647,-3204,20.3,1539.8
4519754998,1,27,1,1,6,5,4,0,0,0,0,16789,7.0,19024,218,72,959,917,21.8,1678.9,17,3,0,5,6,5,1,1,0,0,15830,7.0,18107,213,52,-959,-917,21.3,1583.0
4523054835,1,16,6,1,5,4,4,1,1,0,0,15481,6.8,17409,191,65,-253,111,19.1,1548.1,18,2,0,4,5,2,0,0,0,0,15734,6.6,17298,234,55,253,-111,23.4,1573.4
4524656905,0,16,3,0,9,8,10,1,1,0,0,17586,7.2,18812,227,56,319,1558,22.7,1758.6,15,2,1,8,9,6,0,0,0,0,17267,6.8,17254,232,35,-319,-1558,23.2,1726.7
4524789573,0,14,1,1,6,4,7,0,0,0,0,16508,7.0,18227,204,47,489,-1163,20.4,1650.8,34,2,0,4,6,5,1,0,1,0,16019,7.2,19390,235,58,-489,1163,23.5,1601.9
4458668503,0,15,2,1,2,7,2,0,0,0,0,14270,6.4,15513,215,39,-3519,-4275,21.5,1427.0,14,3,0,7,2,8,1,1,0,0,17789,7.4,19788,241,56,3519,4275,24.1,1778.9
4476983984,0,16,2,1,4,8,4,1,1,0,0,15247,6.6,17064,209,56,-2720,-2473,20.9,1524.7,12,3,0,8,4,9,0,0,0,0,17967,7.2,19537,207,64,2720,2473,20.7,1796.7
4510784617,0,13,19,1,5,8,2,0,0,0,0,16003,7.0,18252,221,50,5,185,22.1,1600.3,45,2,0,8,5,7,1,1,0,0,15998,6.8,18067,189,45,-5,-185,18.9,1599.8
4521573510,0,15,0,0,2,3,4,0,0,0,0,13761,6.6,16433,187,48,-1400,-2239,18.7,1376.1,13,1,1,3,2,1,1,1,0,0,15161,7.0,18672,247,52,1400,2239,24.7,1516.1
4479765492,0,17,2,0,6,9,3,0,0,0,0,16331,7.0,18513,229,47,-1081,-953,22.9,1633.1,16,1,1,9,6,9,1,1,0,0,17412,7.2,19466,235,56,1081,953,23.5,1741.2
4523056452,1,16,2,0,7,5,6,1,1,0,0,16580,7.0,17570,207,36,-334,-1403,20.7,1658.0,15,4,1,5,7,5,0,0,0,0,16914,7.0,18973,228,56,334,1403,22.8,1691.4
4523498928,0,9,0,0,2,9,1,0,0,0,0,13879,6.2,15363,185,48,-4267,-3389,18.5,1387.9,15,2,1,9,2,5,2,1,1,0,18146,7.0,18752,232,56,4267,3389,23.2,1814.6
4502568283,1,15,3,0,7,7,8,2,1,1,1,19435,7.4,19608,248,63,2831,1855,24.8,1943.5,15,1,1,7,7,6,0,0,0,0,16604,6.8,17753,197,48,-2831,-1855,19.7,1660.4
4525371439,1,15,3,1,8,6,12,1,1,0,0,18012,6.6,16748,210,53,2957,2549,21.0,1801.2,47,2,0,6,8,5,0,0,0,0,15055,6.0,14199,177,41,-2957,-2549,17.7,1505.5
4525813376,0,53,5,0,5,11,5,0,0,0,0,15189,7.0,17359,195,48,-4907,-2701,19.5,1518.9,18,3,1,11,5,8,1,1,0,1,20096,7.4,20060,250,51,4907,2701,25.0,2009.6
4508408940,0,35,3,0,3,6,2,1,1,0,0,13879,6.6,16319,148,62,-2967,-3336,14.8,1387.9,14,2,1,6,3,2,0,0,0,0,16846,7.2,19655,223,69,2967,3336,22.3,1684.6
4521001903,1,17,2,0,6,4,7,1,1,0,0,16057,7.0,17977,231,44,172,-278,23.1,1605.7,16,2,1,4,6,7,1,0,1,0,15885,7.0,18255,242,56,-172,278,24.2,1588.5
4519327401,0,16,5,1,6,8,11,1,1,0,0,16031,6.6,17016,215,57,-987,-1705,21.5,1603.1,18,1,0,8,6,8,0,0,0,0,17018,6.8,18721,223,55,987,1705,22.3,1701.8
4522444322,1,12,2,1,6,2,8,1,0,1,0,16897,7.0,18652,234,56,1923,1300,23.4,1689.7,15,2,0,2,6,2,1,1,0,0,14974,6.8,17352,240,48,-1923,-1300,24.0,1497.4
4518043689,1,15,3,1,9,12,15,0,0,0,0,18458,7.0,18924,243,42,-913,-192,24.3,1845.8,18,3,0,12,9,20,0,0,0,0,19371,7.2,19116,231,52,913,192,23.1,1937.1
4516505202,1,15,3,1,4,4,4,0,0,0,0,15722,6.8,17896,224,51,-470,-187,22.4,1572.2,102,1,0,4,4,3,0,0,0,0,16192,7.0,18083,242,48,470,187,24.2,1619.2
4441924667,0,16,6,1,7,5,6,0,0,0,0,16381,7.0,18126,221,56,134,-1142,22.1,1638.1,14,2,0,5,7,3,2,1,1,0,16247,7.2,19268,231,64,-134,1142,23.1,1624.7
4523583459,0,45,10,1,5,7,8,1,1,0,0,15897,7.2,17465,216,59,-503,-896,21.6,1589.7,23,9,0,7,5,7,0,0,0,0,16400,7.0,18361,225,44,503,896,22.5,1640.0
4456179027,0,55,0,0,4,3,2,0,0,0,0,15335,6.8,18648,230,40,-188,270,23.0,1533.5,11,3,1,3,4,2,1,1,0,0,15523,7.0,18378,248,60,188,-270,24.8,1552.3
4518777335,0,25,1,1,3,6,4,0,0,0,0,14564,6.6,16320,209,51,-1966,-1998,20.9,1456.4,15,1,0,6,3,8,1,1,0,0,16530,7.0,18318,220,64,1966,1998,22.0,1653.0
4511374041,0,15,3,0,7,12,6,2,1,1,0,17347,6.6,18118,222,63,-1305,-1101,22.2,1734.7,19,1,1,12,7,15,0,0,0,0,18652,7.4,19219,218,44,1305,1101,21.8,1865.2
4505511340,0,16,6,1,10,9,10,0,0,0,0,17818,6.8,17651,204,41,-1272,-1634,20.4,1781.8,45,9,0,9,10,9,0,0,0,0,19090,7.2,19285,258,36,1272,1634,25.8,1909.0
4513104795,0,39,6,0,3,5,6,0,0,0,0,15365,6.8,18102,216,60,-1519,-1284,21.6,1536.5,24,2,1,5,3,5,0,0,0,0,16884,7.4,19386,245,59,1519,1284,24.5,1688.4
4510924170,0,11,1,1,9,9,14,0,0,0,0,17058,6.4,16359,174,40,-1004,-2008,17.4,1705.8,17,0,0,9,9,14,0,0,0,0,18062,7.0,18367,213,56,1004,2008,21.3,1806.2
4520494460,1,39,3,0,4,7,7,1,1,0,0,15240,6.8,17092,196,60,-1080,-1362,19.6,1524.0,13,1,1,7,4,6,0,0,0,0,16320,7.0,18454,220,47,1080,1362,22.0,1632.0
4517812260,1,42,5,1,10,6,9,2,1,1,0,18747,7.2,19584,225,53,3015,3067,22.5,1874.7,14,5,0,6,10,5,0,0,0,0,15732,6.8,16517,184,60,-3015,-3067,18.4,1573.2
4506779668,0,39,3,0,4,7,4,1,1,0,0,15722,6.8,17329,221,53,-3309,-2741,22.1,1572.2,17,5,1,7,4,9,0,0,0,1,19031,7.4,20070,230,60,3309,2741,23.0,1903.1
4464331919,0,48,2,1,4,4,3,1,0,1,0,15721,7.2,18756,213,64,-1050,89,21.3,1572.1,18,0,0,4,4,6,1,1,0,0,16771,7.2,18667,238,56,1050,-89,23.8,1677.1
4451947704,0,83,2,1,5,5,7,0,0,0,0,16560,7.0,18547,225,50,761,830,22.5,1656.0,38,3,0,5,5,8,1,1,0,0,15799,6.8,17717,225,47,-761,-830,22.5,1579.9
4469769550,0,17,3,0,6,14,4,0,0,0,0,16150,6.6,16419,194,41,-2243,-2024,19.4,1615.0,15,3,1,14,6,13,0,0,0,0,18393,7.0,18443,186,56,2243,2024,18.6,1839.3
4476661914,0,10,0,1,2,11,3,0,0,0,0,14562,6.8,16952,196,68,-4816,-3750,19.6,1456.2,12,1,0,11,2,12,1,1,0,0,19378,7.4,20702,259,48,4816,3750,25.9,1937.8
4483910758,0,12,3,0,3,5,2,1,0,1,0,15385,7.0,17822,227,56,-989,-1102,22.7,1538.5,15,4,1,5,3,3,1,1,0,0,16374,7.4,18924,224,63,989,1102,22.4,1637.4
4508510865,1,17,4,0,5,5,2,0,0,0,0,15775,6.6,16946,249,45,-848,-4,24.9,1577.5,19,3,1,5,5,7,1,1,0,0,16623,6.6,16950,225,53,848,4,22.5,1662.3
4516815119,1,37,1,0,4,9,5,0,0,0,0,15945,6.8,17648,248,35,-781,289,24.8,1594.5,9,2,1,9,4,10,1,1,0,0,16726,6.8,17359,195,48,781,-289,19.5,1672.6
4523400286,1,24,2,0,3,3,4,0,0,0,0,14940,6.6,16977,238,44,-1131,-1921,23.8,1494.0,40,12,1,3,3,2,0,0,0,0,16071,7.0,18898,247,68,1131,1921,24.7,1607.1
4489610844,0,17,4,0,4,13,3,0,0,0,0,15321,6.2,16450,198,44,-4562,-2816,19.8,1532.1,18,3,1,13,4,12,1,0,1,0,19883,7.2,19266,222,43,4562,2816,22.2,1988.3
4492333957,1,14,1,1,9,5,7,1,0,1,0,18348,7.2,19545,216,62,3111,2739,21.6,1834.8,13,0,0,5,9,4,1,1,0,0,15237,6.8,16806,202,51,-3111,-2739,20.2,1523.7
4441748703,1,26,1,1,10,6,9,1,1,0,0,17252,7.0,18227,212,40,1154,999,21.2,1725.2,15,1,0,6,10,5,0,0,0,0,16098,7.0,17228,220,42,-1154,-999,22.0,1609.8
4472684884,1,16,4,0,6,4,6,1,0,1,0,16434,7.0,18330,235,48,-435,574,23.5,1643.4,20,5,1,4,6,8,1,1,0,0,16869,6.8,17756,270,36,435,-574,27.0,1686.9
4421752887,0,17,3,1,4,5,7,0,0,0,0,15574,6.8,17216,236,47,14,-309,23.6,1557.4,35,3,0,5,4,6,2,1,1,0,15560,6.8,17525,224,44,-14,309,22.4,1556.0
4494605842,1,14,3,0,6,11,8,0,0,0,0,16557,6.8,17924,232,55,-2564,170,23.2,1655.7,15,2,1,11,6,25,1,1,0,0,19121,6.8,17754,219,55,2564,-170,21.9,1912.1
4503465904,1,18,4,1,10,2,8,2,1,1,0,18826,7.2,19835,259,52,5616,3916,25.9,1882.6,15,4,0,2,10,2,0,0,0,0,13210,6.6,15919,184,36,-5616,-3916,18.4,1321.0
4504886310,1,18,4,0,5,3,4,1,1,0,0,15979,7.2,18795,260,53,1027,615,26.0,1597.9,19,3,1,3,5,4,0,0,0,0,14952,7.0,18180,219,60,-1027,-615,21.9,1495.2
4522403826,0,16,3,1,6,8,11,0,0,0,0,15758,7.0,16369,204,34,-1561,-1578,20.4,1575.8,17,1,0,8,6,9,0,0,0,0,17319,7.0,17947,213,48,1561,1578,21.3,1731.9
4521175049,0,15,3,0,3,5,3,1,1,0,0,15809,6.8,17675,214,63,-1462,-1833,21.4,1580.9,17,2,1,5,3,8,1,0,1,0,17271,7.4,19508,232,56,1462,1833,23.2,1727.1
4521204334,1,15,0,1,12,5,13,1,0,1,0,19201,7.2,18883,214,67,3982,3457,21.4,1920.1,12,2,0,5,12,7,0,0,0,0,15219,6.2,15426,182,47,-3982,-3457,18.2,1521.9
4517065551,0,18,2,1,8,4,18,0,0,0,0,17691,7.0,18548,222,60,3544,2399,22.2,1769.1,14,3,0,4,8,4,0,0,0,0,14147,6.4,16149,184,44,-3544,-2399,18.4,1414.7
4527291717,0,71,4,0,4,7,2,0,0,0,0,14961,6.8,17673,215,40,-2090,-916,21.5,1496.1,18,3,1,7,4,7,1,1,0,0,17051,7.0,18589,239,56,2090,916,23.9,1705.1
4522569909,0,18,2,0,5,8,10,0,0,0,0,15979,6.8,17379,195,52,-583,360,19.5,1597.9,14,2,1,8,5,9,1,1,0,0,16562,6.6,17019,200,36,583,-360,20.0,1656.2
4515369512,0,10,2,0,6,4,8,0,0,0,0,17099,7.0,18702,208,74,1579,1223,20.8,1709.9,12,1,1,4,6,3,1,1,0,0,15520,6.8,17479,228,43,-1579,-1223,22.8,1552.0
4484154962,0,18,3,1,8,10,7,0,0,0,0,16180,6.6,16639,185,36,-2807,-2956,18.5,1618.0,16,3,0,10,8,17,0,0,0,0,18987,7.4,19595,236,61,2807,2956,23.6,1898.7
4524443617,1,17,3,0,4,1,5,1,1,0,0,16041,7.0,18214,233,44,1891,603,23.3,1604.1,39,2,1,1,4,1,0,0,0,0,14150,7.0,17611,214,47,-1891,-603,21.4,1415.0
4459775765,0,15,2,0,3,4,3,0,0,0,0,14642,6.6,16219,229,36,-744,-1255,22.9,1464.2,17,1,1,4,3,4,2,1,1,0,15386,6.8,17474,212,52,744,1255,21.2,1538.6
4503192981,1,17,4,0,6,5,5,1,0,1,0,16000,6.8,17778,206,60,379,406,20.6,1600.0,16,1,1,5,6,5,1,1,0,0,15621,6.8,17372,214,44,-379,-406,21.4,1562.1
4456461566,1,16,1,1,4,5,4,0,0,0,0,15845,6.8,17682,225,48,463,-8,22.5,1584.5,20,1,0,5,4,5,0,0,0,0,15382,7.0,17690,214,42,-463,8,21.4,1538.2
4524945992,1,11,2,1,11,10,8,1,1,0,0,18104,6.8,17404,205,40,1117,-637,20.5,1810.4,17,0,0,10,11,6,0,0,0,0,16987,6.8,18041,168,41,-1117,637,16.8,1698.7
4442484650,0,13,2,0,2,9,1,0,0,0,0,13569,6.0,14129,165,52,-3535,-3197,16.5,1356.9,15,0,1,9,2,11,2,1,1,0,17104,7.0,17326,215,44,3535,3197,21.5,1710.4
4439065205,0,28,3,0,6,9,9,0,0,0,0,16552,7.0,17597,215,48,-1026,-982,21.5,1655.2,19,3,1,9,6,7,1,1,0,0,17578,7.0,18579,234,52,1026,982,23.4,1757.8
4493209584,0,15,2,0,4,6,3,0,0,0,0,15532,6.8,18026,210,64,-781,-1296,21.0,1553.2,22,1,1,6,4,4,2,1,1,0,16313,7.2,19322,220,58,781,1296,22.0,1631.3
4491649164,1,16,1,0,3,4,3,0,0,0,0,15459,7.0,18000,230,55,-174,231,23.0,1545.9,15,4,1,4,3,5,2,1,1,0,15633,7.0,17769,212,48,174,-231,21.2,1563.3
4517786912,0,14,3,1,5,7,6,2,1,1,0,15157,6.8,17194,218,38,-1301,-502,21.8,1515.7,14,2,0,7,5,8,0,0,0,0,16458,7.0,17696,209,52,1301,502,20.9,1645.8
4519099479,0,16,2,0,7,6,8,0,0,0,0,16286,7.0,17910,223,40,369,561,22.3,1628.6,15,1,1,6,7,8,0,0,0,0,15917,7.0,17349,196,52,-369,-561,19.6,1591.7
4467269037,1,21,4,1,5,1,6,1,1,0,0,16956,7.2,18750,259,56,1723,740,25.9,1695.6,14,2,0,1,5,1,1,0,1,0,15233,6.8,18010,262,64,-1723,-740,26.2,1523.3
4517834101,0,15,2,1,4,12,1,0,0,0,0,15089,6.6,17098,235,53,-5292,-4004,23.5,1508.9,14,4,0,12,4,14,1,1,0,1,20381,7.6,21102,234,63,5292,4004,23.4,2038.1
4519850833,0,10,1,1,5,7,8,0,0,0,0,15548,6.4,16604,191,52,-459,-307,19.1,1554.8,16,2,0,7,5,9,1,1,0,0,16007,6.8,16911,196,40,459,307,19.6,1600.7
4526163863,0,31,3,0,2,7,2,0,0,0,0,15739,7.0,18212,256,53,-1257,-91,25.6,1573.9,16,1,1,7,2,10,1,1,0,0,16996,6.8,18303,234,48,1257,91,23.4,1699.6
4471229287,0,20,3,0,3,8,5,0,0,0,0,13980,6.2,15030,193,44,-3739,-3541,19.3,1398.0,39,1,1,8,3,9,2,1,1,0,17719,7.2,18571,246,48,3739,3541,24.6,1771.9
4464352676,1,17,3,0,7,10,7,1,0,1,0,16375,6.8,17469,177,51,-3183,-1884,17.7,1637.5,15,5,1,10,7,9,0,0,0,1,19558,7.2,19353,236,72,3183,1884,23.6,1955.8
4524035367,0,17,4,0,1,1,1,0,0,0,0,14018,7.0,16730,233,51,152,-1124,23.3,1401.8,41,3,1,1,1,1,1,1,0,0,13866,7.2,17854,220,56,-152,1124,22.0,1386.6
4396684519,0,16,3,0,8,6,13,1,1,0,0,17003,6.8,17843,222,43,253,-1300,22.2,1700.3,18,3,1,6,8,7,0,0,0,0,16750,7.2,19143,218,75,-253,1300,21.8,1675.0
4486740435,0,13,2,0,4,13,2,0,0,0,0,14969,6.6,16183,208,43,-4486,-5334,20.8,1496.9,23,2,1,13,4,8,0,0,0,0,19455,7.6,21517,222,59,4486,5334,22.2,1945.5
4476854395,1,27,3,0,3,8,1,0,0,0,0,14418,6.4,16672,206,52,-2778,-2174,20.6,1441.8,16,5,1,8,3,7,2,1,1,0,17196,7.0,18846,205,52,2778,2174,20.5,1719.6
4495332793,0,12,0,0,2,3,2,1,0,1,0,14191,6.8,16725,207,48,-1093,-1572,20.7,1419.1,119,1,1,3,2,3,0,0,0,0,15284,7.2,18297,239,55,1093,1572,23.9,1528.4
4502001730,1,25,4,0,11,6,12,0,0,0,0,19537,7.0,18358,189,60,2718,1185,18.9,1953.7,20,1,1,6,11,8,1,1,0,0,16819,7.0,17173,211,48,-2718,-1185,21.1,1681.9
4524617778,0,37,8,1,3,2,2,1,0,1,0,16091,7.6,20383,256,76,1188,2851,25.6,1609.1,20,2,0,2,3,3,1,1,0,0,14903,7.0,17532,244,56,-1188,-2851,24.4,1490.3
4471437748,1,18,6,0,6,4,5,1,1,0,0,17002,7.2,18755,218,71,2536,3339,21.8,1700.2,14,3,1,4,6,0,1,0,1,0,14466,6.4,15416,210,35,-2536,-3339,21.0,1446.6
4525140164,1,14,2,1,8,9,7,0,0,0,0,17047,7.0,17601,200,47,-97,165,20.0,1704.7,16,3,0,9,8,6,1,1,0,0,17144,6.8,17436,198,48,97,-165,19.8,1714.4
4516563869,1,14,4,1,8,6,10,1,1,0,0,17776,6.8,18126,224,45,1072,411,22.4,1777.6,17,2,0,6,8,8,0,0,0,0,16704,6.6,17715,238,51,-1072,-411,23.8,1670.4
4525009804,0,14,1,1,7,6,7,1,1,0,0,16938,7.2,18493,223,60,206,-453,22.3,1693.8,17,0,0,6,7,3,1,0,1,0,16732,7.4,18946,234,56,-206,453,23.4,1673.2
4513724737,0,13,6,1,2,5,2,1,1,0,0,14514,7.0,17851,211,63,-1386,-450,21.1,1451.4,39,2,0,5,2,1,0,0,0,0,15900,6.8,18301,242,55,1386,450,24.2,1590.0
4497671680,0,82,3,1,5,4,7,0,0,0,0,16035,6.6,17246,193,44,408,165,19.3,1603.5,15,2,0,4,5,6,1,1,0,0,15627,6.8,17081,224,56,-408,-165,22.4,1562.7
4519264088,1,15,2,0,5,8,7,0,0,0,0,16519,7.2,19018,210,76,-180,2299,21.0,1651.9,17,1,1,8,5,7,2,1,1,0,16699,6.6,16719,192,48,180,-2299,19.2,1669.9
4524013226,1,23,1,0,2,5,3,2,1,1,0,14974,7.0,18286,224,60,-726,-31,22.4,1497.4,15,5,1,5,2,5,0,0,0,0,15700,7.0,18317,216,61,726,31,21.6,1570.0
4524384067,0,43,1,0,4,5,5,1,0,1,0,15157,7.0,17954,201,55,-1321,-7,20.1,1515.7,15,2,1,5,4,10,0,0,0,0,16478,7.0,17961,235,47,1321,7,23.5,1647.8
4487099602,1,33,1,1,9,5,8,0,0,0,0,16959,7.2,19195,199,43,1788,1922,19.9,1695.9,15,2,0,5,9,2,0,0,0,0,15171,6.6,17273,187,44,-1788,-1922,18.7,1517.1
4497647589,1,18,2,1,8,0,6,0,0,0,0,18609,7.2,19904,244,64,5109,3009,24.4,1860.9,14,2,0,0,8,0,1,1,0,0,13500,6.6,16895,216,56,-5109,-3009,21.6,1350.0
4460730840,1,24,5,1,13,4,16,1,1,0,0,20029,7.4,20123,213,54,6445,4988,21.3,2002.9,17,2,0,4,13,4,0,0,0,0,13584,6.0,15135,176,29,-6445,-4988,17.6,1358.4
4462423061,0,14,1,1,7,12,5,0,0,0,0,16125,6.8,17377,196,40,-3290,-2697,19.6,1612.5,17,1,0,12,7,14,0,0,0,0,19415,7.2,20074,231,47,3290,2697,23.1,1941.5
4484657293,1,21,4,1,8,4,11,1,1,0,0,18382,7.0,19220,224,68,2498,1487,22.4,1838.2,15,5,0,4,8,5,0,0,0,0,15884,7.0,17733,217,52,-2498,-1487,21.7,1588.4
4524067975,0,14,6,0,1,6,1,0,0,0,0,13075,6.4,15488,169,56,-6309,-3115,16.9,1307.5,19,1,1,6,1,5,0,0,0,1,19384,7.2,18603,270,48,6309,3115,27.0,1938.4
4470118865,0,15,3,0,1,4,0,0,0,0,0,14928,7.0,18640,229,81,-360,331,22.9,1492.8,13,5,1,4,1,2,1,1,0,0,15288,7.0,18309,213,46,360,-331,21.3,1528.8
4467388375,1,16,2,1,9,1,7,2,1,1,0,17710,7.2,19233,230,55,4311,3239,23.0,1771.0,12,1,0,1,9,0,0,0,0,0,13399,6.6,15994,201,44,-4311,-3239,20.1,1339.9
4507431568,1,14,2,1,5,6,7,0,0,0,0,16503,7.0,18377,240,59,171,42,24.0,1650.3,48,1,0,6,5,10,1,1,0,0,16332,7.0,18335,232,54,-171,-42,23.2,1633.2
4524110261,0,12,0,0,6,10,4,0,0,0,0,15475,6.4,15944,205,42,-2395,-3117,20.5,1547.5,37,1,1,10,6,13,1,1,0,0,17870,7.2,19061,210,53,2395,3117,21.0,1787.0
4527078007,1,58,1,1,12,9,13,1,0,1,0,19104,7.0,17733,204,48,2241,1077,20.4,1910.4,17,2,0,9,12,11,1,1,0,0,16863,6.8,16656,200,48,-2241,-1077,20.0,1686.3
4494350446,1,16,1,1,8,4,7,2,1,1,0,17634,7.0,19000,242,46,2018,2261,24.2,1763.4,31,1,0,4,8,2,0,0,0,0,15616,6.6,16739,233,50,-2018,-2261,23.3,1561.6
4469649522,0,53,5,0,4,11,3,0,0,0,0,15440,6.8,16864,207,44,-3368,-3384,20.7,1544.0,17,1,1,11,4,17,0,0,0,0,18808,7.4,20248,216,68,3368,3384,21.6,1880.8
4519989854,1,22,3,1,10,3,8,2,1,1,0,19082,7.2,18868,231,60,5391,2596,23.1,1908.2,13,5,0,3,10,2,0,0,0,0,13691,6.2,16272,176,48,-5391,-2596,17.6,1369.1
4518127728,0,15,1,1,4,8,3,0,0,0,0,15525,6.6,16079,198,60,-1784,-2938,19.8,1552.5,35,2,0,8,4,7,0,0,0,0,17309,7.0,19017,227,48,1784,2938,22.7,1730.9
4481630032,0,18,1,1,5,1,6,1,1,0,0,15381,7.0,17703,211,51,759,657,21.1,1538.1,15,6,0,1,5,0,0,0,0,0,14622,6.8,17046,245,50,-759,-657,24.5,1462.2
4465357470,0,19,2,0,5,6,3,0,0,0,0,15722,6.8,17153,224,40,-488,-98,22.4,1572.2,16,3,1,6,5,7,1,1,0,0,16210,6.8,17251,192,48,488,98,19.2,1621.0
4450464581,0,17,7,1,6,9,7,0,0,0,0,16035,6.6,17041,196,52,-2257,-2894,19.6,1603.5,40,3,0,9,6,5,1,1,0,0,18292,7.4,19935,230,52,2257,2894,23.0,1829.2
4465066223,1,13,1,0,6,9,2,1,1,0,0,16250,7.0,17537,228,55,-556,-235,22.8,1625.0,17,1,1,9,6,13,0,0,0,0,16806,6.8,17772,143,60,556,235,14.3,1680.6
4522849346,0,86,3,1,6,3,6,1,0,1,0,17395,7.2,18998,252,56,2234,1606,25.2,1739.5,22,2,0,3,6,5,1,1,0,0,15161,7.0,17392,226,56,-2234,-1606,22.6,1516.1
4525329096,0,13,4,1,2,4,2,0,0,0,0,14842,7.0,17857,231,48,270,679,23.1,1484.2,17,2,0,4,2,3,1,1,0,0,14572,6.8,17178,193,41,-270,-679,19.3,1457.2
4522857741,1,18,4,1,3,3,5,1,1,0,0,15200,6.8,17127,230,56,662,33,23.0,1520.0,15,4,0,3,3,3,0,0,0,0,14538,6.6,17094,202,47,-662,-33,20.2,1453.8
4517741452,1,38,0,1,6,4,7,2,1,1,0,16886,6.8,18261,221,56,184,-131,22.1,1688.6,16,4,0,4,6,5,0,0,0,0,16702,7.0,18392,237,64,-184,131,23.7,1670.2
4515543803,0,18,3,0,7,6,6,0,0,0,0,15847,6.6,16305,199,36,-1252,-1190,19.9,1584.7,16,5,1,6,7,6,1,0,1,0,17099,6.6,17495,231,51,1252,1190,23.1,1709.9
4453159239,1,13,3,0,5,10,3,0,0,0,0,15067,6.6,16500,203,38,-3574,-387,20.3,1506.7,11,0,1,10,5,14,1,0,1,0,18641,6.6,16887,218,40,3574,387,21.8,1864.1
4478080352,0,16,1,0,0,8,0,0,0,0,0,12988,6.2,14678,153,78,-5264,-4627,15.3,1298.8,21,5,1,8,0,10,2,1,1,0,18252,7.2,19305,273,44,5264,4627,27.3,1825.2
4489963680,0,77,3,1,8,11,12,1,0,1,0,16842,6.4,16280,210,28,-1725,-2264,21.0,1684.2,39,1,0,11,8,13,1,1,0,0,18567,7.0,18544,192,56,1725,2264,19.2,1856.7
4527646038,0,16,5,0,10,11,12,0,0,0,0,17788,6.8,17829,159,59,-275,-739,15.9,1778.8,20,4,1,11,10,7,0,0,0,0,18063,7.0,18568,212,55,275,739,21.2,1806.3
4470395952,0,15,5,1,5,4,8,0,0,0,0,16163,7.0,18437,242,41,1074,542,24.2,1616.3,40,5,0,4,5,8,1,0,1,0,15089,7.0,17895,224,39,-1074,-542,22.4,1508.9
4495098102,1,39,3,1,10,6,12,2,1,1,1,19669,7.4,19333,220,62,4456,2338,22.0,1966.9,14,3,0,6,10,3,0,0,0,0,15213,6.6,16995,196,40,-4456,-2338,19.6,1521.3
4510307677,1,17,1,1,11,4,14,1,1,0,0,17961,7.2,19152,205,41,3354,2760,20.5,1796.1,13,0,0,4,11,5,0,0,0,0,14607,6.8,16392,206,32,-3354,-2760,20.6,1460.7
4518296609,0,15,3,0,5,4,6,1,1,0,0,16086,7.0,18044,222,68,441,626,22.2,1608.6,16,2,1,4,5,5,0,0,0,0,15645,6.8,17418,235,44,-441,-626,23.5,1564.5
4527598275,0,54,3,0,7,8,10,0,0,0,0,16238,6.8,17694,202,50,-982,1441,20.2,1623.8,11,4,1,8,7,10,1,1,0,0,17220,6.6,16253,185,64,982,-1441,18.5,1722.0
4520558243,1,18,2,1,9,6,7,1,1,0,0,17016,7.2,18560,210,60,338,-232,21.0,1701.6,12,2,0,6,9,7,0,0,0,0,16678,7.0,18792,212,56,-338,232,21.2,1667.8
4522178825,1,16,2,1,5,6,5,1,1,0,0,15901,6.8,16965,213,44,324,-409,21.3,1590.1,15,1,0,6,5,6,0,0,0,0,15577,6.6,17374,207,40,-324,409,20.7,1557.7
4519092330,0,15,1,0,1,3,1,0,0,0,0,13943,6.8,17418,235,37,-1661,-1064,23.5,1394.3,14,0,1,3,1,2,0,0,0,0,15604,7.0,18482,241,48,1661,1064,24.1,1560.4
4457158751,0,17,5,1,7,4,6,1,0,1,0,16460,7.0,18260,241,51,1561,-87,24.1,1646.0,17,4,0,4,7,0,1,1,0,0,14899,7.2,18347,197,77,-1561,87,19.7,1489.9
4470447299,0,17,3,0,4,7,6,0,0,0,0,15190,6.6,16345,196,47,-1903,-584,19.6,1519.0,42,4,1,7,4,14,1,1,0,0,17093,6.6,16929,206,64,1903,584,20.6,1709.3
4510971608,0,14,4,0,3,11,4,1,1,0,0,14017,6.6,16410,182,56,-4941,-2777,18.2,1401.7,16,4,1,11,3,8,0,0,0,0,18958,7.4,19187,227,44,4941,2777,22.7,1895.8
4478115052,0,42,2,0,6,5,7,1,0,1,0,17098,7.4,20021,243,54,447,919,24.3,1709.8,89,1,1,5,6,6,0,0,0,0,16651,7.0,19102,220,67,-447,-919,22.0,1665.1
4524326952,1,19,0,0,9,6,9,0,0,0,0,17368,6.8,18134,219,40,280,-1018,21.9,1736.8,15,3,1,6,9,8,0,0,0,0,17088,7.2,19152,227,59,-280,1018,22.7,1708.8
4443464607,1,12,3,0,4,7,3,1,1,0,0,15586,7.0,18599,229,52,-1777,52,22.9,1558.6,24,0,1,7,4,7,0,0,0,0,17363,7.2,18547,244,49,1777,-52,24.4,1736.3
4517934723,0,38,3,0,8,12,6,0,0,0,0,16760,7.2,18264,217,36,-1302,73,21.7,1676.0,146,3,1,12,8,8,1,1,0,0,18062,7.0,18191,199,36,1302,-73,19.9,1806.2
4489423422,0,17,4,1,7,8,6,0,0,0,0,16199,6.6,16645,206,48,-811,-798,20.6,1619.9,15,4,0,8,7,8,1,1,0,0,17010,6.8,17443,192,56,811,798,19.2,1701.0
4492054165,0,58,2,1,4,8,1,0,0,0,0,14807,6.8,17294,201,56,-2462,-1894,20.1,1480.7,15,2,0,8,4,6,0,0,0,0,17269,7.4,19188,229,56,2462,1894,22.9,1726.9
4494889837,0,15,2,0,3,7,4,0,0,0,0,14584,6.8,16798,220,49,-2543,-1202,22.0,1458.4,18,3,1,7,3,7,1,1,0,0,17127,7.0,18000,258,38,2543,1202,25.8,1712.7
4523384060,0,11,1,1,3,4,1,0,0,0,0,15336,7.0,17953,253,43,-761,-10,25.3,1533.6,14,1,0,4,3,5,1,0,1,0,16097,6.8,17963,219,52,761,10,21.9,1609.7
4498508859,1,15,0,1,9,6,15,0,0,0,0,18847,7.0,19097,218,68,2197,233,21.8,1884.7,15,2,0,6,9,8,1,1,0,0,16650,7.4,18864,236,44,-2197,-233,23.6,1665.0
4508316147,1,21,3,1,7,4,7,1,1,0,0,17247,7.0,18201,223,48,2145,870,22.3,1724.7,15,4,0,4,7,5,0,0,0,0,15102,6.8,17331,231,29,-2145,-870,23.1,1510.2
4497518760,0,16,2,1,6,4,2,1,1,0,0,16803,7.0,18812,255,61,1189,1151,25.5,1680.3,19,2,0,4,6,5,0,0,0,0,15614,7.2,17661,206,59,-1189,-1151,20.6,1561.4
4524222412,1,14,2,1,7,7,5,1,1,0,0,16045,6.8,17256,216,48,-282,-79,21.6,1604.5,12,1,0,7,7,9,1,0,1,0,16327,7.0,17335,182,53,282,79,18.2,1632.7
4505990555,1,15,3,1,6,3,12,0,0,0,0,16925,6.6,17065,212,40,784,-2929,21.2,1692.5,15,2,0,3,6,2,0,0,0,0,16141,7.2,19994,224,91,-784,2929,22.4,1614.1
4527354441,0,37,17,0,3,5,2,0,0,0,0,15630,7.0,18378,254,48,-1092,-324,25.4,1563.0,36,3,1,5,3,7,0,0,0,0,16722,7.0,18702,264,44,1092,324,26.4,1672.2
4513953505,1,26,5,0,2,2,2,1,1,0,0,14541,6.8,18354,240,48,-1345,-621,24.0,1454.1,15,2,1,2,2,2,0,0,0,0,15886,7.2,18975,260,61,1345,621,26.0,1588.6
4513650091,0,19,3,1,8,3,4,1,0,1,1,19224,7.6,20086,225,56,4674,2219,22.5,1922.4,34,3,0,3,8,4,1,1,0,0,14550,7.0,17867,189,64,-4674,-2219,18.9,1455.0
4522494083,1,15,3,1,12,5,13,0,0,0,0,19835,7.4,19690,223,48,4675,3054,22.3,1983.5,13,2,0,5,12,5,1,1,0,0,15160,6.8,16636,169,48,-4675,-3054,16.9,1516.0
4463402176,1,21,6,0,9,7,10,0,0,0,0,17329,6.8,17577,223,48,675,691,22.3,1732.9,28,6,1,7,9,6,2,1,1,0,16654,6.8,16886,227,30,-675,-691,22.7,1665.4
4525072110,1,89,2,1,13,4,13,1,0,1,0,19569,7.2,19298,203,36,5148,2308,20.3,1956.9,42,4,0,4,13,2,1,1,0,0,14421,6.8,16990,179,51,-5148,-2308,17.9,1442.1
4489796229,1,20,3,1,6,5,4,1,1,0,0,16130,6.8,17004,235,36,149,447,23.5,1613.0,15,7,0,5,6,3,0,0,0,0,15981,6.6,16557,241,40,-149,-447,24.1,1598.1
4525337352,1,14,4,0,4,5,1,1,1,0,0,15202,7.0,18246,240,56,-947,1016,24.0,1520.2,17,2,1,5,4,7,0,0,0,0,16149,6.8,17230,231,46,947,-1016,23.1,1614.9
4519072442,0,13,1,1,5,14,4,0,0,0,0,15787,6.6,15849,200,40,-3783,-3300,20.0,1578.7,30,4,0,14,5,12,1,1,0,0,19570,7.2,19149,201,61,3783,3300,20.1,1957.0
4522421841,1,20,2,1,8,7,11,1,1,0,1,18744,6.8,18677,210,55,2858,1988,21.0,1874.4,14,2,0,7,8,7,0,0,0,0,15886,6.8,16689,174,56,-2858,-1988,17.4,1588.6
4505416038,0,56,1,1,2,1,4,0,0,0,0,15755,7.0,18468,258,69,1684,1773,25.8,1575.5,16,3,0,1,2,1,0,0,0,0,14071,6.8,16695,212,56,-1684,-1773,21.2,1407.1
4472696992,1,19,2,0,5,5,5,0,0,0,0,16853,7.2,18782,233,48,213,-583,23.3,1685.3,33,2,1,5,5,2,0,0,0,0,16640,7.0,19365,249,57,-213,583,24.9,1664.0
4517829998,0,14,1,1,9,5,11,1,0,1,1,18967,7.2,17807,231,42,3652,1542,23.1,1896.7,40,1,0,5,9,7,0,0,0,0,15315,6.4,16265,194,44,-3652,-1542,19.4,1531.5
4471979738,0,17,1,1,12,8,10,1,1,0,0,19079,7.0,18774,206,58,1330,854,20.6,1907.9,16,1,0,8,12,7,0,0,0,0,17749,7.0,17920,212,48,-1330,-854,21.2,1774.9
4502334465,1,18,4,1,11,8,16,1,0,1,1,20639,7.2,18457,207,61,4639,3197,20.7,2063.9,15,3,0,8,11,10,1,1,0,0,16000,6.2,15260,159,55,-4639,-3197,15.9,1600.0
4517776059,1,17,3,1,10,1,8,1,1,0,0,18646,7.0,19491,237,49,5148,2922,23.7,1864.6,12,2,0,1,10,0,0,0,0,0,13498,6.4,16569,210,43,-5148,-2922,21.0,1349.8
4457599634,1,17,2,1,7,8,4,1,1,0,0,17222,7.2,19032,216,75,485,219,21.6,1722.2,16,2,0,8,7,7,0,0,0,0,16737,7.0,18813,202,28,-485,-219,20.2,1673.7
4442356832,0,29,3,1,4,11,5,0,0,0,0,15046,6.8,17088,214,36,-4939,-3731,21.4,1504.6,16,2,0,11,4,16,1,0,1,0,19985,7.6,20819,251,69,4939,3731,25.1,1998.5
4489404475,1,18,3,0,7,5,8,0,0,0,0,16525,6.8,17494,191,51,67,-303,19.1,1652.5,15,0,1,5,7,5,0,0,0,0,16458,7.0,17797,228,46,-67,303,22.8,1645.8
4515658862,0,36,5,0,2,7,2,1,0,1,0,15279,7.0,18355,236,59,-1526,-1082,23.6,1527.9,14,6,1,7,2,10,1,1,0,0,16805,7.4,19437,236,40,1526,1082,23.6,1680.5
4526460873,1,16,4,0,4,6,2,1,1,0,0,14993,6.8,16922,223,44,-1449,-539,22.3,1499.3,19,6,1,6,4,6,0,0,0,0,16442,6.8,17461,255,40,1449,539,25.5,1644.2
4514826109,1,17,1,0,9,6,11,1,1,0,0,16863,7.0,18740,227,32,296,1370,22.7,1686.3,12,2,1,6,9,3,0,0,0,0,16567,7.0,17370,222,48,-296,-1370,22.2,1656.7
4500738441,0,23,2,1,5,9,4,0,0,0,0,15675,6.6,16844,229,39,-1614,-2256,22.9,1567.5,14,3,0,9,5,12,1,1,0,0,17289,7.2,19100,215,56,1614,2256,21.5,1728.9
4470749064,1,16,1,0,6,7,6,0,0,0,0,16881,7.0,18851,228,56,-216,301,22.8,1688.1,13,2,1,7,6,6,0,0,0,0,17097,7.0,18550,233,44,216,-301,23.3,1709.7
4506680103,0,16,4,1,11,9,12,0,0,0,0,18200,7.0,17815,202,39,1211,-757,20.2,1820.0,18,3,0,9,11,10,1,1,0,0,16989,7.2,18572,211,60,-1211,757,21.1,1698.9
4478110348,0,14,5,1,3,4,2,0,0,0,0,14490,6.8,17534,226,37,-1759,-2019,22.6,1449.0,41,3,0,4,3,1,1,1,0,0,16249,7.2,19553,247,58,1759,2019,24.7,1624.9
4526108051,0,18,1,0,9,7,9,0,0,0,0,17556,7.2,18967,214,59,805,1723,21.4,1755.6,12,3,1,7,9,12,1,1,0,0,16751,6.8,17244,230,36,-805,-1723,23.0,1675.1
4500429958,0,15,1,1,7,7,8,1,1,0,0,16812,6.8,17939,226,52,-260,-369,22.6,1681.2,51,2,0,7,7,7,0,0,0,0,17072,7.2,18308,233,53,260,369,23.3,1707.2
4476445956,0,16,2,0,4,11,2,2,1,1,0,14657,6.8,16983,188,59,-3113,-1771,18.8,1465.7,20,1,1,11,4,20,0,0,0,0,17770,7.2,18754,201,45,3113,1771,20.1,1777.0
4469723831,1,13,1,1,6,1,2,2,1,1,3,21051,7.4,20745,276,70,8776,8348,27.6,2105.1,14,1,0,1,6,1,0,0,0,0,12275,5.4,12397,176,20,-8776,-8348,17.6,1227.5
4524451001,1,17,4,1,8,8,10,0,0,0,0,15996,6.2,15159,185,36,-2523,-2980,18.5,1599.6,16,8,0,8,8,10,1,0,1,0,18519,6.8,18139,231,40,2523,2980,23.1,1851.9
4519524460,0,17,2,0,2,4,1,0,0,0,0,14144,6.8,17041,208,42,-1122,-643,20.8,1414.4,16,4,1,4,2,1,1,1,0,0,15266,6.8,17684,230,46,1122,643,23.0,1526.6
4522377959,0,15,0,0,10,5,14,0,0,0,0,17993,6.6,16834,222,36,2876,2805,22.2,1799.3,14,3,1,5,10,8,0,0,0,0,15117,6.0,14029,180,36,-2876,-2805,18.0,1511.7
4520610441,0,41,2,1,6,7,8,0,0,0,0,15756,6.6,16210,204,49,-1966,-3189,20.4,1575.6,18,4,0,7,6,6,0,0,0,0,17722,7.4,19399,242,60,1966,3189,24.2,1772.2
4526932906,0,21,3,1,5,9,6,0,0,0,0,16462,7.0,17215,223,52,-922,-1305,22.3,1646.2,12,2,0,9,5,11,2,1,1,0,17384,7.2,18520,227,49,922,1305,22.7,1738.4
4524068681,1,16,3,1,3,3,3,0,0,0,0,15045,6.6,16887,221,46,220,-284,22.1,1504.5,19,3,0,3,3,5,0,0,0,0,14825,6.8,17171,199,39,-220,284,19.9,1482.5
4387753545,1,16,3,1,11,10,12,1,1,0,0,18286,6.6,16569,183,31,149,-1568,18.3,1828.6,11,4,0,10,11,12,1,0,1,0,18137,7.0,18137,205,53,-149,1568,20.5,1813.7
4487676643,1,15,2,1,6,4,4,0,0,0,0,16792,7.2,18901,238,52,1852,2113,23.8,1679.2,20,1,0,4,6,5,0,0,0,0,14940,6.6,16788,218,40,-1852,-2113,21.8,1494.0
4507588254,1,18,2,1,10,0,16,0,0,0,0,18059,7.0,18165,218,44,5224,2715,21.8,1805.9,15,1,0,0,10,0,1,1,0,0,12835,6.4,15450,200,41,-5224,-2715,20.0,1283.5
4523260482,1,36,8,1,7,4,11,1,1,0,0,16482,6.6,16880,222,46,1086,756,22.2,1648.2,21,4,0,4,7,6,0,0,0,0,15396,6.4,16124,212,58,-1086,-756,21.2,1539.6
4508360116,1,37,3,1,6,5,7,1,1,0,0,16149,7.0,18253,217,44,-549,-323,21.7,1614.9,15,3,0,5,6,5,0,0,0,0,16698,6.8,18576,233,59,549,323,23.3,1669.8
4520718276,0,16,3,1,4,10,4,1,0,1,0,15773,6.6,16701,216,44,-2175,-2305,21.6,1577.3,23,3,0,10,4,12,1,1,0,0,17948,7.2,19006,216,42,2175,2305,21.6,1794.8
4523066845,0,40,1,0,8,4,10,0,0,0,0,16411,6.6,17513,176,43,590,1002,17.6,1641.1,16,5,1,4,8,4,0,0,0,0,15821,6.6,16511,208,47,-590,-1002,20.8,1582.1
4490186049,1,15,4,0,4,4,1,2,1,1,0,16292,7.2,18889,274,50,1229,1059,27.4,1629.2,18,2,1,4,4,2,0,0,0,0,15063,7.0,17830,220,50,-1229,-1059,22.0,1506.3
4522659821,0,15,3,0,1,3,2,0,0,0,0,14114,6.8,17618,229,55,-1313,-6,22.9,1411.4,18,2,1,3,1,5,2,1,1,0,15427,6.8,17624,250,48,1313,6,25.0,1542.7
4491631842,1,31,5,1,4,4,4,1,1,0,0,16095,7.0,18669,241,65,-262,-375,24.1,1609.5,24,3,0,4,4,2,0,0,0,0,16357,7.2,19044,257,55,262,375,25.7,1635.7
4518422789,1,18,2,0,8,3,9,2,1,1,0,17561,7.2,19417,222,49,2585,3290,22.2,1756.1,19,3,1,3,8,4,0,0,0,0,14976,6.4,16127,222,43,-2585,-3290,22.2,1497.6
4507088738,0,40,1,0,4,6,3,1,0,1,0,15505,6.8,18109,215,40,-875,-363,21.5,1550.5,12,4,1,6,4,4,1,1,0,0,16380,7.2,18472,232,48,875,363,23.2,1638.0
4460036381,1,13,1,0,3,7,3,1,1,0,0,14659,6.2,15944,193,48,-944,-2050,19.3,1465.9,13,1,1,7,3,6,0,0,0,0,15603,6.8,17994,213,48,944,2050,21.3,1560.3
4512811324,1,23,3,0,10,5,16,0,0,0,0,17272,6.4,15840,192,40,2171,-261,19.2,1727.2,37,2,1,5,10,6,2,1,1,0,15101,6.6,16101,199,40,-2171,261,19.9,1510.1
4514331863,1,16,4,0,16,7,16,1,1,0,1,20300,7.4,19812,192,44,3309,2603,19.2,2030.0,213,5,1,7,16,6,1,0,1,0,16991,6.8,17209,194,48,-3309,-2603,19.4,1699.1
4513253618,0,20,0,0,8,8,5,1,0,1,0,16763,6.8,17433,193,54,-219,-1440,19.3,1676.3,15,2,1,8,8,6,1,1,0,0,16982,7.2,18873,183,58,219,1440,18.3,1698.2
4526103377,1,86,2,0,5,6,7,0,0,0,0,16123,6.8,17612,203,60,569,304,20.3,1612.3,15,2,1,6,5,4,1,1,0,0,15554,6.8,17308,181,60,-569,-304,18.1,1555.4
4523322738,1,17,3,1,8,8,8,1,0,1,0,17022,7.0,19318,237,50,-900,1475,23.7,1702.2,16,2,0,8,8,12,1,1,0,0,17922,7.0,17843,203,45,900,-1475,20.3,1792.2
4492722693,1,13,1,1,8,5,8,0,0,0,0,17953,6.8,18196,218,59,3363,2997,21.8,1795.3,13,2,0,5,8,9,1,1,0,0,14590,6.4,15199,176,43,-3363,-2997,17.6,1459.0
4500061522,0,15,4,0,5,8,1,0,0,0,0,14897,7.0,17306,212,47,-1770,325,21.2,1489.7,16,2,1,8,5,9,1,1,0,0,16667,6.8,16981,191,46,1770,-325,19.1,1666.7
4476200313,1,16,4,0,8,2,6,1,1,0,0,17315,7.2,18903,232,47,4064,3736,23.2,1731.5,16,6,1,2,8,1,0,0,0,0,13251,6.2,15167,181,45,-4064,-3736,18.1,1325.1
4513214208,0,42,3,0,7,8,10,0,0,0,0,16337,6.8,17367,197,47,-38,281,19.7,1633.7,15,4,1,8,7,4,1,1,0,0,16375,6.6,17086,192,43,38,-281,19.2,1637.5
4498735941,0,14,1,0,7,8,8,1,0,1,0,17127,7.0,17974,243,45,-373,-212,24.3,1712.7,19,2,1,8,7,10,1,1,0,0,17500,7.0,18186,229,47,373,212,22.9,1750.0
4500173548,1,18,3,1,7,8,9,1,0,1,0,16276,7.0,17562,195,40,-1216,-629,19.5,1627.6,16,3,0,8,7,10,0,0,0,0,17492,7.0,18191,210,76,1216,629,21.0,1749.2
4475997366,0,19,1,1,6,3,6,1,0,1,0,17170,6.8,18330,238,56,2241,639,23.8,1717.0,15,2,0,3,6,3,0,0,0,0,14929,6.6,17691,214,60,-2241,-639,21.4,1492.9
4514530513,0,12,1,0,6,11,5,0,0,0,0,16281,6.8,17569,209,53,-2082,-2125,20.9,1628.1,14,0,1,11,6,9,1,1,0,0,18363,7.4,19694,206,64,2082,2125,20.6,1836.3
4496533687,1,14,4,0,4,8,3,1,1,0,0,15049,7.0,17666,218,52,-2088,-870,21.8,1504.9,16,3,1,8,4,7,0,0,0,0,17137,7.2,18536,240,47,2088,870,24.0,1713.7
4462344917,1,36,7,0,9,2,9,1,1,0,0,17964,7.4,19813,213,69,3311,3991,21.3,1796.4,15,1,1,2,9,2,0,0,0,0,14653,6.4,15822,198,51,-3311,-3991,19.8,1465.3
4473029808,1,47,4,0,12,2,18,0,0,0,0,19336,7.4,19593,221,59,4680,2780,22.1,1933.6,14,2,1,2,12,2,0,0,0,0,14656,6.8,16813,214,60,-4680,-2780,21.4,1465.6
4488128761,0,32,2,1,10,11,10,0,0,0,0,17593,6.8,17439,178,49,-1538,-1233,17.8,1759.3,15,1,0,11,10,15,2,1,1,0,19131,7.0,18672,201,55,1538,1233,20.1,1913.1
4523538705,1,13,2,0,12,3,12,1,1,0,0,19226,7.4,20579,228,61,4389,5412,22.8,1922.6,17,2,1,3,12,5,0,0,0,0,14837,6.4,15167,217,35,-4389,-5412,21.7,1483.7
4518540865,1,12,3,1,12,7,13,0,0,0,0,19049,7.6,20348,225,48,2900,2308,22.5,1904.9,14,1,0,7,12,5,1,1,0,0,16149,6.8,18040,172,52,-2900,-2308,17.2,1614.9
4508388395,1,16,2,1,15,2,17,1,1,0,1,21883,7.8,20941,252,55,7980,4916,25.2,2188.3,12,1,0,2,15,0,0,0,0,0,13903,6.4,16025,193,44,-7980,-4916,19.3,1390.3
4520798666,0,16,3,1,5,2,5,0,0,0,0,15048,6.4,16614,182,48,384,872,18.2,1504.8,18,5,0,2,5,2,1,1,0,0,14664,6.6,15742,229,48,-384,-872,22.9,1466.4
4524986663,1,14,2,1,8,4,5,0,0,0,0,17198,6.8,17495,226,37,2973,1838,22.6,1719.8,32,4,0,4,8,5,1,1,0,0,14225,6.2,15657,141,56,-2973,-1838,14.1,1422.5
4518495220,1,14,0,1,8,8,4,2,1,1,0,16459,6.8,17550,190,48,-335,-213,19.0,1645.9,16,0,0,8,8,7,0,0,0,0,16794,7.0,17763,209,57,335,213,20.9,1679.4
4526197736,0,38,1,0,10,8,14,1,1,0,0,18294,7.4,18581,204,43,1058,527,20.4,1829.4,12,1,1,8,10,12,0,0,0,0,17236,7.0,18054,210,46,-1058,-527,21.0,1723.6
4503099396,1,21,6,1,5,7,5,0,0,0,0,16514,6.8,18012,244,48,-17,-514,24.4,1651.4,17,4,0,7,5,10,1,1,0,0,16531,7.0,18526,209,48,17,514,20.9,1653.1
4512160768,0,11,1,1,2,3,5,1,1,0,0,14305,6.8,17323,214,47,-1517,-972,21.4,1430.5,16,0,0,3,2,3,1,0,1,0,15822,7.0,18295,225,68,1517,972,22.5,1582.2
4457630115,0,33,2,1,6,5,7,0,0,0,0,16879,7.4,19265,203,68,-29,1014,20.3,1687.9,39,2,0,5,6,7,2,1,1,0,16908,7.0,18251,249,43,29,-1014,24.9,1690.8
4473156943,1,14,0,0,6,9,7,0,0,0,0,15809,7.0,18227,202,62,-2167,-1158,20.2,1580.9,32,2,1,9,6,6,0,0,0,0,17976,7.2,19385,243,53,2167,1158,24.3,1797.6
4487298777,0,13,7,0,2,9,3,0,0,0,0,13860,6.8,16225,195,39,-4138,-3792,19.5,1386.0,40,3,1,9,2,7,1,0,1,0,17998,7.4,20017,229,52,4138,3792,22.9,1799.8
4527087399,1,13,1,0,6,7,6,0,0,0,0,16070,6.6,17613,194,48,-1245,-971,19.4,1607.0,13,2,1,7,6,10,1,1,0,0,17315,7.0,18584,237,60,1245,971,23.7,1731.5
4464340157,0,13,0,0,5,12,11,1,1,0,0,14353,6.2,15067,168,48,-4550,-3483,16.8,1435.3,11,1,1,12,5,19,0,0,0,0,18903,7.2,18550,216,39,4550,3483,21.6,1890.3
4518119286,1,17,0,1,6,6,7,1,1,0,0,16521,6.8,17859,214,56,90,-1069,21.4,1652.1,17,1,0,6,6,3,1,0,1,0,16431,7.2,18928,243,52,-90,1069,24.3,1643.1
4523021460,1,15,3,1,3,1,3,0,0,0,0,16956,7.0,18863,270,55,3560,2311,27.0,1695.6,45,2,0,1,3,0,0,0,0,0,13396,6.6,16552,198,51,-3560,-2311,19.8,1339.6
4517748263,1,13,5,1,6,5,3,0,0,0,0,16590,7.0,19180,228,43,1209,1099,22.8,1659.0,13,1,0,5,6,10,1,1,0,0,15381,7.0,18081,202,52,-1209,-1099,20.2,1538.1
4459570157,1,14,2,1,6,7,8,1,0,1,1,19056,7.4,19650,232,72,2638,2423,23.2,1905.6,16,1,0,7,6,12,0,0,0,0,16418,6.8,17227,204,37,-2638,-2423,20.4,1641.8
4521842384,1,12,4,0,3,5,6,0,0,0,0,14771,7.0,17825,227,44,-1426,-26,22.7,1477.1,24,2,1,5,3,4,2,1,1,0,16197,7.0,17851,218,52,1426,26,21.8,1619.7
4521148922,1,16,3,1,9,5,18,2,1,1,1,19011,7.0,17878,201,57,3451,202,20.1,1901.1,46,1,0,5,9,4,0,0,0,0,15560,7.0,17676,224,44,-3451,-202,22.4,1556.0
4456161907,0,146,3,1,2,4,1,0,0,0,0,14848,6.8,17467,205,65,-132,119,20.5,1484.8,15,2,0,4,2,3,1,1,0,0,14980,6.8,17348,213,44,132,-119,21.3,1498.0
4453464076,0,32,3,1,8,8,6,1,1,0,0,17761,7.2,19090,220,64,642,-3,22.0,1776.1,17,3,0,8,8,6,0,0,0,0,17119,7.2,19093,218,44,-642,3,21.8,1711.9
4477182015,0,15,3,1,4,10,5,1,1,0,0,15403,6.6,17392,242,48,-2613,-1974,24.2,1540.3,40,3,0,10,4,15,1,0,1,0,18016,7.0,19366,230,48,2613,1974,23.0,1801.6
4519157822,0,28,2,1,9,6,11,0,0,0,0,17210,6.6,17039,195,36,643,-8,19.5,1721.0,15,6,0,6,9,8,0,0,0,0,16567,6.8,17047,197,55,-643,8,19.7,1656.7
4505843833,1,15,5,1,11,9,8,0,0,0,0,17528,7.0,18271,191,48,171,618,19.1,1752.8,37,3,0,9,11,10,0,0,0,0,17357,6.6,17653,209,32,-171,-618,20.9,1735.7
4514792667,0,14,2,1,3,7,3,0,0,0,0,14110,6.4,15832,162,48,-2566,-2246,16.2,1411.0,15,2,0,7,3,3,0,0,0,0,16676,6.8,18078,228,47,2566,2246,22.8,1667.6
4500687748,0,16,6,0,3,4,2,1,0,1,0,15527,6.8,18231,223,48,-564,-298,22.3,1552.7,19,4,1,4,3,7,1,1,0,0,16091,7.0,18529,246,67,564,298,24.6,1609.1
4526971230,1,16,2,0,7,6,4,0,0,0,0,15473,6.8,17556,195,48,-1174,-778,19.5,1547.3,14,3,1,6,7,5,0,0,0,0,16647,7.2,18334,221,38,1174,778,22.1,1664.7
4519178537,0,16,3,0,4,5,3,0,0,0,0,14893,6.8,17322,203,48,-1002,-378,20.3,1489.3,16,2,1,5,4,4,1,1,0,0,15895,6.8,17700,233,48,1002,378,23.3,1589.5
4524783374,1,33,2,0,14,10,9,0,0,0,0,18595,7.0,18307,199,48,1543,-21,19.9,1859.5,37,3,1,10,14,8,1,1,0,0,17052,7.0,18328,172,52,-1543,21,17.2,1705.2
4521257483,1,10,2,1,7,8,9,0,0,0,0,17371,7.0,18243,227,41,-50,563,22.7,1737.1,19,2,0,8,7,9,1,1,0,0,17421,6.8,17680,222,56,50,-563,22.2,1742.1
4476639744,0,16,1,0,4,4,4,0,0,0,0,15778,7.2,18381,219,40,36,-325,21.9,1577.8,15,0,1,4,4,1,0,0,0,0,15742,7.2,18706,220,64,-36,325,22.0,1574.2
4478517508,1,19,5,1,7,3,13,1,1,0,0,16997,6.8,17603,227,44,2107,1105,22.7,1699.7,17,3,0,3,7,5,0,0,0,0,14890,6.6,16498,220,48,-2107,-1105,22.0,1489.0
4515575207,1,18,1,1,13,2,11,1,1,0,0,19867,7.0,19401,236,58,6977,5303,23.6,1986.7,13,1,0,2,13,4,0,0,0,0,12890,5.8,14098,168,33,-6977,-5303,16.8,1289.0
4521716722,1,17,1,1,4,8,2,0,0,0,0,16152,7.0,18347,212,59,-633,-502,21.2,1615.2,139,2,0,8,4,14,1,1,0,0,16785,7.0,18849,196,53,633,502,19.6,1678.5
4457626899,1,18,3,1,4,8,4,1,0,1,0,16657,7.0,18154,210,58,-206,-1476,21.0,1665.7,17,6,0,8,4,0,1,1,0,0,16863,7.2,19630,248,52,206,1476,24.8,1686.3
4523618632,1,15,5,1,6,3,11,1,1,0,0,16389,7.0,17937,241,36,817,-94,24.1,1638.9,38,2,0,3,6,3,0,0,0,0,15572,6.8,18031,229,58,-817,94,22.9,1557.2
4521641532,1,12,4,1,6,6,3,0,0,0,0,16701,6.8,17820,237,40,882,450,23.7,1670.1,18,2,0,6,6,5,0,0,0,0,15819,6.8,17370,192,56,-882,-450,19.2,1581.9
4438165073,0,17,3,1,5,9,5,1,1,0,0,15921,6.8,17353,210,68,-1490,-1624,21.0,1592.1,16,4,0,9,5,14,0,0,0,0,17411,7.2,18977,215,52,1490,1624,21.5,1741.1
4489438593,1,15,2,0,8,6,6,0,0,0,0,16947,7.0,18862,184,64,-538,1677,18.4,1694.7,17,2,1,6,8,8,2,1,1,1,17485,6.8,17185,198,47,538,-1677,19.8,1748.5
4473009756,0,13,2,0,7,7,10,1,1,0,0,16397,6.6,17090,222,40,-1023,-2028,22.2,1639.7,39,1,1,7,7,6,0,0,0,0,17420,7.2,19118,243,52,1023,2028,24.3,1742.0
4460718392,0,14,0,0,0,12,0,0,0,0,0,12002,6.0,13961,151,44,-8461,-7340,15.1,1200.2,58,3,1,12,0,9,0,0,0,1,20463,7.8,21301,238,52,8461,7340,23.8,2046.3
4459925036,0,14,2,0,2,14,3,0,0,0,0,14332,6.4,15949,219,51,-5624,-4155,21.9,1433.2,19,2,1,14,2,19,1,1,0,0,19956,7.4,20104,226,49,5624,4155,22.6,1995.6
4521969261,1,11,0,1,5,6,4,1,1,0,0,15548,7.0,18653,181,68,-1238,-1708,18.1,1554.8,17,1,0,6,5,5,0,0,0,0,16786,7.4,20361,219,60,1238,1708,21.9,1678.6
4518370041,0,19,4,1,6,6,8,2,1,1,0,17258,7.0,18225,239,58,1191,-311,23.9,1725.8,16,1,0,6,6,5,0,0,0,0,16067,6.8,18536,213,60,-1191,311,21.3,1606.7
4513437508,1,14,3,1,7,1,5,0,0,0,0,16961,7.2,19188,245,43,4060,3257,24.5,1696.1,16,0,0,1,7,1,0,0,0,0,12901,6.4,15931,176,45,-4060,-3257,17.6,1290.1
4476906757,1,20,8,1,2,2,1,0,0,0,0,14814,7.0,18414,233,60,500,1220,23.3,1481.4,20,5,0,2,2,5,1,0,1,0,14314,6.8,17194,213,48,-500,-1220,21.3,1431.4
4454458141,0,16,2,0,4,7,4,0,0,0,0,16216,7.0,17978,233,40,-872,-432,23.3,1621.6,86,5,1,7,4,8,1,0,1,0,17088,7.0,18410,213,53,872,432,21.3,1708.8
4518851187,0,15,2,0,1,6,1,0,0,0,0,13427,6.8,16472,211,44,-3175,-1845,21.1,1342.7,16,4,1,6,1,5,1,1,0,0,16602,7.0,18317,217,64,3175,1845,21.7,1660.2
4518920963,0,68,2,0,4,5,8,0,0,0,0,15594,7.0,17492,233,52,366,1230,23.3,1559.4,42,5,1,5,4,4,1,1,0,0,15228,6.8,16262,205,40,-366,-1230,20.5,1522.8
4495147066,0,13,1,0,2,9,2,0,0,0,0,13267,6.2,14831,185,40,-5292,-4922,18.5,1326.7,14,3,1,9,2,12,1,1,0,0,18559,7.2,19753,237,64,5292,4922,23.7,1855.9
4524019203,0,19,4,0,8,5,9,0,0,0,0,18098,7.2,19504,212,76,2730,3068,21.2,1809.8,19,2,1,5,8,2,1,1,0,0,15368,6.4,16436,215,40,-2730,-3068,21.5,1536.8
4506223983,1,18,2,1,11,7,9,1,1,0,0,18913,6.6,17351,229,38,3002,1582,22.9,1891.3,9,2,0,7,11,8,0,0,0,0,15911,6.4,15769,170,45,-3002,-1582,17.0,1591.1
4525792479,1,40,3,1,6,6,8,1,1,0,0,16961,6.8,17778,238,48,-33,-998,23.8,1696.1,15,13,0,6,6,4,1,0,1,0,16994,7.0,18776,213,58,33,998,21.3,1699.4
4515526880,0,32,4,0,3,10,3,0,0,0,0,15067,6.6,15937,186,39,-2968,-3336,18.6,1506.7,21,1,1,10,3,11,1,1,0,0,18035,7.4,19273,214,57,2968,3336,21.4,1803.5
4500946527,0,17,3,0,2,8,4,0,0,0,0,14845,6.4,16713,236,49,-3193,-2101,23.6,1484.5,120,3,1,8,2,14,1,1,0,0,18038,7.2,18814,207,61,3193,2101,20.7,1803.8
4519879315,1,53,3,1,8,8,4,0,0,0,0,17236,7.2,19937,235,64,-308,1739,23.5,1723.6,17,2,0,8,8,10,1,1,0,0,17544,6.8,18198,220,60,308,-1739,22.0,1754.4
4526187847,0,15,6,0,4,10,3,0,0,0,0,15119,6.4,16068,201,28,-3770,-2959,20.1,1511.9,13,2,1,10,4,12,0,0,0,0,18889,7.0,19027,213,59,3770,2959,21.3,1888.9
4507871318,1,18,5,0,11,7,14,0,0,0,0,18793,7.0,18395,217,37,3026,3357,21.7,1879.3,20,2,1,7,11,8,1,1,0,0,15767,6.4,15038,174,37,-3026,-3357,17.4,1576.7
4520730804,1,21,6,1,3,1,2,2,1,1,0,15530,6.8,17715,235,52,1219,232,23.5,1553.0,42,4,0,1,3,3,0,0,0,0,14311,6.8,17483,238,46,-1219,-232,23.8,1431.1
4475203157,0,15,6,1,6,2,11,0,0,0,0,17955,7.2,18774,270,43,3187,880,27.0,1795.5,17,1,0,2,6,1,1,1,0,0,14768,6.8,17894,230,64,-3187,-880,23.0,1476.8
4516499874,0,13,1,0,10,12,13,1,1,0,0,17842,6.8,18236,194,52,-1949,-1074,19.4,1784.2,15,3,1,12,10,12,0,0,0,0,19791,7.2,19310,228,46,1949,1074,22.8,1979.1
4523456850,0,14,2,0,5,11,3,0,0,0,1,15961,6.6,16916,199,36,-2066,3,19.9,1596.1,12,1,1,11,5,14,1,1,0,0,18027,6.8,16913,200,56,2066,-3,20.0,1802.7
4525797575,0,16,1,0,7,10,8,0,0,0,0,16900,6.8,16827,161,47,-1920,-3055,16.1,1690.0,17,5,1,10,7,8,1,1,0,0,18820,7.2,19882,225,70,1920,3055,22.5,1882.0
4446243794,1,16,4,0,1,5,1,2,1,1,0,14942,7.0,17727,210,83,-1215,-756,21.0,1494.2,21,3,1,5,1,7,0,0,0,0,16157,7.0,18483,233,52,1215,756,23.3,1615.7
4508113644,0,39,2,1,7,15,13,0,0,0,0,17181,7.0,18481,184,47,-2692,-1609,18.4,1718.1,55,3,0,15,7,20,1,1,0,0,19873,7.4,20090,191,34,2692,1609,19.1,1987.3
4492065807,1,15,4,1,8,4,12,0,0,0,0,18498,7.2,18641,232,48,2759,980,23.2,1849.8,18,0,0,4,8,2,1,1,0,0,15739,7.0,17661,215,43,-2759,-980,21.5,1573.9
4484642493,1,15,2,1,6,3,5,0,0,0,0,16542,7.0,19014,214,63,1428,1200,21.4,1654.2,17,3,0,3,6,4,1,1,0,0,15114,7.0,17814,238,56,-1428,-1200,23.8,1511.4
4457248839,1,14,2,0,13,7,11,0,0,0,0,18692,7.4,19886,238,40,1872,3579,23.8,1869.2,13,2,1,7,13,11,0,0,0,0,16820,6.6,16307,215,36,-1872,-3579,21.5,1682.0
4521530707,1,8,1,1,9,8,11,1,1,0,0,17049,6.8,17343,180,49,147,-1425,18.0,1704.9,13,1,0,8,9,8,0,0,0,0,16902,7.2,18768,193,63,-147,1425,19.3,1690.2
4493967269,0,54,4,0,8,7,9,0,0,0,0,16355,7.0,17876,193,44,-495,934,19.3,1635.5,16,2,1,7,8,7,1,1,0,0,16850,6.6,16942,191,60,495,-934,19.1,1685.0
4516759278,1,21,5,1,8,4,7,1,1,0,1,17790,6.8,17688,190,56,1837,458,19.0,1779.0,86,2,0,4,8,4,1,0,1,0,15953,6.8,17230,176,68,-1837,-458,17.6,1595.3
4524256472,1,23,6,1,7,6,5,1,1,0,0,16898,7.0,17534,226,53,599,267,22.6,1689.8,29,6,0,6,7,7,1,0,1,0,16299,6.8,17267,203,50,-599,-267,20.3,1629.9
4519229533,0,15,2,1,4,3,7,1,1,0,0,15669,7.0,17654,223,57,273,-1110,22.3,1566.9,21,3,0,3,4,3,0,0,0,0,15396,7.2,18764,237,56,-273,1110,23.7,1539.6
4526015422,1,15,1,1,2,0,4,2,1,1,0,15919,6.6,17737,262,56,1935,411,26.2,1591.9,17,3,0,0,2,0,0,0,0,0,13984,6.6,17326,244,55,-1935,-411,24.4,1398.4
4493638317,1,14,5,0,3,4,2,1,0,1,0,15318,6.8,17968,235,49,-942,120,23.5,1531.8,16,2,1,4,3,5,1,1,0,0,16260,6.8,17848,263,44,942,-120,26.3,1626.0
4525786511,1,18,4,0,8,2,10,1,0,1,1,18656,7.2,19071,229,45,3761,1269,22.9,1865.6,37,3,1,2,8,2,0,0,0,0,14895,6.6,17802,241,52,-3761,-1269,24.1,1489.5
4420481816,0,18,4,0,8,3,7,1,0,1,0,17574,7.2,19195,252,44,2774,2207,25.2,1757.4,15,4,1,3,8,2,1,1,0,0,14800,6.6,16988,225,47,-2774,-2207,22.5,1480.0
4515607398,1,19,2,0,8,3,7,1,1,0,0,18003,7.4,20207,248,77,3034,1983,24.8,1800.3,15,4,1,3,8,2,0,0,0,0,14969,7.0,18224,211,52,-3034,-1983,21.1,1496.9
4527808251,0,38,2,0,3,2,4,0,0,0,0,15249,7.2,19121,240,45,-162,1520,24.0,1524.9,17,4,1,2,3,3,2,1,1,0,15411,6.8,17601,248,40,162,-1520,24.8,1541.1
4518045882,1,17,1,1,4,5,4,1,1,0,0,15519,6.8,17775,236,45,-859,-1502,23.6,1551.9,24,3,0,5,4,5,0,0,0,0,16378,7.2,19277,237,65,859,1502,23.7,1637.8
4483811680,0,41,2,0,5,5,8,0,0,0,0,15675,6.4,16501,218,39,549,224,21.8,1567.5,12,2,1,5,5,7,1,1,0,0,15126,6.6,16277,170,36,-549,-224,17.0,1512.6
4521846073,1,22,2,1,6,5,7,1,0,1,0,16937,7.0,18194,221,43,592,242,22.1,1693.7,14,3,0,5,6,4,1,1,0,0,16345,7.2,17952,215,67,-592,-242,21.5,1634.5
4471157611,1,15,2,0,4,5,4,0,0,0,0,15761,7.0,17783,230,59,-802,-1243,23.0,1576.1,17,2,1,5,4,5,0,0,0,0,16563,7.4,19026,247,54,802,1243,24.7,1656.3
4522283833,1,13,1,0,4,5,7,0,0,0,0,15921,7.0,18190,217,48,-594,-353,21.7,1592.1,14,1,1,5,4,7,2,1,1,0,16515,7.2,18543,235,48,594,353,23.5,1651.5
4517996305,0,18,3,0,1,9,1,0,0,0,0,13599,6.4,15596,229,32,-5031,-5211,22.9,1359.9,16,3,1,9,1,6,0,0,0,0,18630,7.6,20807,241,71,5031,5211,24.1,1863.0
4520750598,1,15,0,1,7,2,3,1,1,0,1,18662,7.4,19321,255,66,4088,2662,25.5,1866.2,16,2,0,2,7,2,0,0,0,0,14574,6.6,16659,209,64,-4088,-2662,20.9,1457.4
4493204321,0,15,2,0,2,8,1,0,0,0,0,14826,6.6,16327,222,37,-1635,-1544,22.2,1482.6,17,4,1,8,2,12,2,1,1,0,16461,6.8,17871,210,50,1635,1544,21.0,1646.1
4509344771,1,12,1,0,4,7,4,1,0,1,0,15891,7.2,19024,200,59,-820,-298,20.0,1589.1,35,1,1,7,4,7,1,1,0,0,16711,7.4,19322,214,48,820,298,21.4,1671.1
4491522681,0,14,2,0,3,4,2,0,0,0,0,15369,7.0,17785,221,57,-482,-349,22.1,1536.9,19,6,1,4,3,5,1,1,0,0,15851,7.0,18134,257,56,482,349,25.7,1585.1
4516772132,0,16,2,1,2,5,1,1,0,1,1,15951,7.0,18136,236,42,-675,-1212,23.6,1595.1,17,3,0,5,2,6,0,0,0,0,16626,7.2,19348,234,60,675,1212,23.4,1662.6
4522201208,0,35,1,0,5,3,5,1,0,1,1,17854,7.4,20383,230,56,2323,2120,23.0,1785.4,13,1,1,3,5,2,0,0,0,0,15531,7.0,18263,219,52,-2323,-2120,21.9,1553.1
4524104535,1,13,2,1,7,2,5,1,0,1,0,16242,7.0,17867,218,48,2156,2101,21.8,1624.2,17,0,0,2,7,3,0,0,0,0,14086,6.4,15766,212,38,-2156,-2101,21.2,1408.6
4527531982,0,15,3,0,10,13,7,0,0,0,0,17938,7.0,18477,150,29,-1415,-1826,15.0,1793.8,72,5,1,13,10,7,0,0,0,0,19353,7.6,20303,196,60,1415,1826,19.6,1935.3
4519632042,1,49,2,0,5,4,6,0,0,0,0,15217,7.0,18056,195,49,-784,754,19.5,1521.7,16,9,1,4,5,5,1,1,0,0,16001,6.6,17302,238,54,784,-754,23.8,1600.1
4516319678,0,15,1,1,6,2,7,1,0,1,0,16583,7.0,18071,244,52,2191,1140,24.4,1658.3,16,4,0,2,6,1,1,1,0,0,14392,6.8,16931,218,52,-2191,-1140,21.8,1439.2
4514409289,1,12,8,1,8,7,7,1,1,0,0,16840,7.2,19004,193,51,-144,-157,19.3,1684.0,42,3,0,7,8,7,0,0,0,0,16984,7.2,19161,218,56,144,157,21.8,1698.4
4526171046,1,15,3,0,8,3,9,0,0,0,0,18334,7.0,19209,232,40,3770,1556,23.2,1833.4,37,1,1,3,8,2,1,1,0,0,14564,6.8,17653,195,59,-3770,-1556,19.5,1456.4
4524202231,1,14,2,1,9,4,6,1,1,0,0,18532,7.4,20134,231,55,3195,1370,23.1,1853.2,124,2,0,4,9,1,0,0,0,0,15337,7.2,18764,223,64,-3195,-1370,22.3,1533.7
4516368750,0,18,3,1,9,7,8,0,0,0,0,17944,7.2,18559,255,40,1319,41,25.5,1794.4,17,4,0,7,9,4,1,1,0,0,16625,7.0,18518,234,56,-1319,-41,23.4,1662.5
4525985539,1,13,1,1,11,5,9,0,0,0,0,18590,7.0,18992,215,44,2945,2019,21.5,1859.0,14,1,0,5,11,7,1,0,1,0,15645,6.6,16973,202,48,-2945,-2019,20.2,1564.5
4520641910,1,14,0,1,6,2,5,2,1,1,0,17215,7.0,19549,264,57,1978,1595,26.4,1721.5,13,1,0,2,6,2,0,0,0,0,15237,7.0,17954,199,71,-1978,-1595,19.9,1523.7
4495813537,1,16,4,1,8,4,9,1,0,1,0,18001,7.2,19477,233,55,2111,1390,23.3,1800.1,16,6,0,4,8,5,1,1,0,0,15890,6.8,18087,228,71,-2111,-1390,22.8,1589.0
4524303948,0,39,1,0,7,6,7,0,0,0,0,15551,6.4,15956,176,42,-259,-576,17.6,1555.1,14,2,1,6,7,6,0,0,0,0,15810,6.6,16532,173,49,259,576,17.3,1581.0
4501265779,0,12,2,0,8,6,7,0,0,0,0,16793,6.8,17595,210,36,115,-80,21.0,1679.3,14,3,1,6,8,6,1,1,0,0,16678,6.8,17675,238,41,-115,80,23.8,1667.8
4514750583,1,13,1,1,6,2,4,0,0,0,0,16853,6.8,18346,234,44,2097,1569,23.4,1685.3,106,2,0,2,6,1,0,0,0,0,14756,6.6,16777,228,50,-2097,-1569,22.8,1475.6
4517057084,0,14,0,0,7,9,8,0,0,0,0,16278,6.6,16530,181,36,-1829,-1668,18.1,1627.8,14,2,1,9,7,10,1,1,0,0,18107,7.0,18198,212,52,1829,1668,21.2,1810.7
4514399530,0,12,0,0,6,10,9,0,0,0,0,16291,6.8,17343,188,52,-2893,-2027,18.8,1629.1,14,2,1,10,6,15,2,1,1,0,19184,7.2,19370,236,60,2893,2027,23.6,1918.4
4516367790,1,46,3,0,5,7,2,0,0,0,0,14871,6.8,16941,180,47,-1682,-563,18.0,1487.1,20,1,1,7,5,9,1,1,0,0,16553,6.8,17504,191,36,1682,563,19.1,1655.3
4449441137,1,37,4,0,8,3,8,0,0,0,0,16896,7.4,19116,225,45,1447,2623,22.5,1689.6,85,3,1,3,8,2,1,1,0,0,15449,6.4,16493,190,52,-1447,-2623,19.0,1544.9
4489787025,0,16,4,1,3,2,2,0,0,0,0,15426,7.0,17927,202,64,566,-248,20.2,1542.6,132,5,0,2,3,0,0,0,0,0,14860,6.8,18175,249,52,-566,248,24.9,1486.0
4521675950,1,14,2,0,10,4,9,1,1,0,0,18779,7.2,19556,252,47,3679,2110,25.2,1877.9,60,0,1,4,10,3,0,0,0,0,15100,6.6,17446,203,56,-3679,-2110,20.3,1510.0
4483692276,1,15,2,1,6,5,7,1,0,1,0,17674,7.2,19752,225,80,2521,3096,22.5,1767.4,56,1,0,5,6,8,0,0,0,0,15153,6.6,16656,217,36,-2521,-3096,21.7,1515.3
4521223652,1,15,1,0,4,3,4,1,1,0,0,15237,7.0,17965,205,60,724,2025,20.5,1523.7,49,3,1,3,4,4,1,0,1,0,14513,6.2,15940,206,32,-724,-2025,20.6,1451.3
4499525448,0,13,3,0,3,9,5,1,1,0,0,14559,6.8,17148,193,56,-4140,-2177,19.3,1455.9,104,3,1,9,3,8,0,0,0,0,18699,7.4,19325,236,42,4140,2177,23.6,1869.9
4505568037,0,18,15,1,6,6,6,2,1,1,0,15771,6.8,17334,187,59,-2842,-1722,18.7,1577.1,37,4,0,6,6,9,0,0,0,1,18613,7.0,19056,264,52,2842,1722,26.4,1861.3
4523348814,0,18,3,1,7,3,6,1,0,1,0,16300,7.0,18376,226,47,286,-12,22.6,1630.0,16,7,0,3,7,2,1,1,0,0,16014,6.8,18388,239,56,-286,12,23.9,1601.4
4470015740,1,19,3,1,4,2,7,1,0,1,0,15648,6.8,17420,216,65,1187,285,21.6,1564.8,20,4,0,2,4,2,1,1,0,0,14461,6.6,17135,215,60,-1187,-285,21.5,1446.1
4515518787,0,11,0,0,3,7,3,0,0,0,0,14381,6.6,16919,202,41,-2528,-993,20.2,1438.1,14,0,1,7,3,10,1,1,0,0,16909,6.8,17912,196,51,2528,993,19.6,1690.9
4477076121,0,14,2,0,4,8,3,0,0,0,0,16138,7.0,17604,217,51,-1531,-2275,21.7,1613.8,20,3,1,8,4,7,0,0,0,0,17669,7.4,19879,228,44,1531,2275,22.8,1766.9
4499966434,0,27,1,0,7,3,7,0,0,0,0,18284,7.2,19460,224,66,2748,2277,22.4,1828.4,16,3,1,3,7,2,1,1,0,0,15536,7.0,17183,211,66,-2748,-2277,21.1,1553.6
4517973417,1,15,5,1,7,1,10,1,1,0,0,16932,7.2,19942,235,55,2699,2575,23.5,1693.2,53,5,0,1,7,1,0,0,0,0,14233,6.8,17367,242,52,-2699,-2575,24.2,1423.3
4516034199,0,12,4,0,2,8,2,1,1,0,0,15421,7.2,19276,217,84,-2771,-1125,21.7,1542.1,14,2,1,8,2,5,0,0,0,0,18192,7.4,20401,234,64,2771,1125,23.4,1819.2
4467720133,1,15,8,1,10,4,10,2,1,1,0,18818,7.4,19037,215,60,4107,1820,21.5,1881.8,18,3,0,4,10,2,0,0,0,0,14711,6.8,17217,209,49,-4107,-1820,20.9,1471.1
4487058187,1,16,4,1,9,1,9,1,1,0,0,17239,7.2,19459,232,46,3497,3543,23.2,1723.9,16,1,0,1,9,2,0,0,0,0,13742,6.4,15916,223,53,-3497,-3543,22.3,1374.2
4526702861,0,16,0,1,2,2,0,0,0,0,0,14828,7.2,18414,237,68,-507,343,23.7,1482.8,14,3,0,2,2,3,1,1,0,0,15335,7.0,18071,260,40,507,-343,26.0,1533.5
4450237694,1,19,5,1,8,9,9,0,0,0,0,18529,7.2,19610,251,63,1334,656,25.1,1852.9,38,4,0,9,8,11,1,1,0,0,17195,7.0,18954,202,60,-1334,-656,20.2,1719.5
4486714617,0,21,2,0,1,8,1,0,0,0,0,14022,6.8,16586,223,59,-4075,-3154,22.3,1402.2,15,2,1,8,1,7,2,1,1,1,18097,7.2,19740,211,60,4075,3154,21.1,1809.7
4474734161,0,11,3,0,6,10,10,0,0,0,0,14901,6.2,14483,170,38,-2834,-3402,17.0,1490.1,25,5,1,10,6,9,1,1,0,0,17735,7.0,17885,216,56,2834,3402,21.6,1773.5
4417615828,0,14,1,0,6,6,7,1,1,0,0,16642,7.0,18251,218,52,-348,-611,21.8,1664.2,15,0,1,6,6,4,1,0,1,0,16990,7.0,18862,237,40,348,611,23.7,1699.0
4447747806,1,15,0,1,9,5,8,0,0,0,0,18192,6.8,18534,229,44,3518,2843,22.9,1819.2,12,0,0,5,9,7,1,1,0,0,14674,6.4,15691,188,32,-3518,-2843,18.8,1467.4
4500109652,0,13,3,0,6,9,3,0,0,0,0,15398,6.6,17682,184,40,-2115,-1147,18.4,1539.8,13,2,1,9,6,6,0,0,0,0,17513,7.0,18829,233,36,2115,1147,23.3,1751.3
4520798455,1,15,2,1,5,5,6,0,0,0,0,16248,7.2,18554,251,40,1144,464,25.1,1624.8,13,3,0,5,5,5,0,0,0,0,15104,7.0,18090,199,56,-1144,-464,19.9,1510.4
4501224571,0,13,1,0,5,8,3,0,0,0,0,15318,7.0,18578,200,48,-1086,646,20.0,1531.8,35,1,1,8,5,8,2,1,1,0,16404,6.8,17932,194,43,1086,-646,19.4,1640.4
4516724538,1,17,3,1,8,3,7,1,0,1,0,19318,7.8,21508,257,71,4787,4701,25.7,1931.8,31,2,0,3,8,1,1,1,0,0,14531,6.6,16807,230,50,-4787,-4701,23.0,1453.1
4519249108,0,16,3,0,0,6,0,0,0,0,0,12698,6.2,15550,195,48,-3784,-4019,19.5,1269.8,13,2,1,6,0,11,1,1,0,0,16482,7.4,19569,222,60,3784,4019,22.2,1648.2
4522867814,1,20,12,1,4,5,5,0,0,0,0,15463,7.2,18378,215,60,25,327,21.5,1546.3,50,7,0,5,4,5,0,0,0,0,15438,7.0,18051,215,44,-25,-327,21.5,1543.8
4513550456,0,16,6,1,5,9,4,0,0,0,0,16105,7.0,17701,237,52,-1198,-833,23.7,1610.5,19,4,0,9,5,8,1,0,1,0,17303,7.2,18534,230,40,1198,833,23.0,1730.3
4512340309,0,12,2,1,10,9,14,0,0,0,0,18178,7.0,17725,213,34,342,-646,21.3,1817.8,15,1,0,9,10,8,1,1,0,0,17836,7.0,18371,222,54,-342,646,22.2,1783.6
4526431738,0,12,4,0,3,8,3,0,0,0,0,14264,6.2,15870,201,28,-2234,-2021,20.1,1426.4,16,2,1,8,3,6,1,1,0,0,16498,6.8,17891,204,56,2234,2021,20.4,1649.8
4506343146,0,18,3,1,5,6,7,1,1,0,0,15425,7.0,17540,208,51,-1611,-1931,20.8,1542.5,16,6,0,6,5,6,0,0,0,0,17036,7.4,19471,246,56,1611,1931,24.6,1703.6
4495223559,1,17,3,0,10,7,7,1,0,1,1,19606,7.2,18619,220,45,3534,2345,22.0,1960.6,16,2,1,7,10,8,1,1,0,0,16072,6.6,16274,170,60,-3534,-2345,17.0,1607.2
4499791451,1,23,2,1,13,3,15,0,0,0,0,19484,7.2,19688,235,50,4694,2781,23.5,1948.4,14,1,0,3,13,3,2,1,1,0,14790,6.6,16907,196,59,-4694,-2781,19.6,1479.0
4505960953,1,16,3,0,10,7,12,0,0,0,0,17839,7.0,18614,201,48,1452,689,20.1,1783.9,39,1,1,7,10,5,1,1,0,0,16387,7.2,17925,198,56,-1452,-689,19.8,1638.7
4524829735,0,35,3,0,7,9,9,0,0,0,0,17482,7.2,18618,233,42,-561,-489,23.3,1748.2,16,3,1,9,7,9,0,0,0,0,18043,7.2,19107,224,41,561,489,22.4,1804.3
4462140519,1,14,4,0,11,7,13,1,1,0,0,18877,7.2,19556,209,54,1711,1767,20.9,1887.7,15,3,1,7,11,7,0,0,0,0,17166,7.0,17789,215,46,-1711,-1767,21.5,1716.6
4519990304,1,16,3,1,7,4,9,2,1,1,0,17897,7.0,18898,237,46,2332,637,23.7,1789.7,16,2,0,4,7,4,0,0,0,0,15565,7.0,18261,190,68,-2332,-637,19.0,1556.5
4472343262,0,13,2,1,3,2,5,1,0,1,0,15649,7.2,18818,227,67,-334,-1054,22.7,1564.9,54,3,0,2,3,1,1,1,0,0,15983,7.4,19872,238,84,334,1054,23.8,1598.3
4439587692,1,19,1,1,8,4,5,1,1,0,1,18355,7.0,18790,218,54,2756,1683,21.8,1835.5,13,5,0,4,8,5,0,0,0,0,15599,6.8,17107,200,57,-2756,-1683,20.0,1559.9
4520800745,1,16,1,0,6,10,6,1,1,0,0,15936,6.6,17184,233,36,-2542,-1008,23.3,1593.6,17,2,1,10,6,9,0,0,0,0,18478,7.0,18192,233,52,2542,1008,23.3,1847.8
4517920600,1,16,4,0,6,7,5,1,1,0,0,15882,7.2,18675,198,68,-1019,-361,19.8,1588.2,15,3,1,7,6,5,0,0,0,0,16901,7.0,19036,240,56,1019,361,24.0,1690.1
4509595307,0,38,4,0,2,5,2,0,0,0,0,13889,6.8,16733,193,57,-1656,-453,19.3,1388.9,13,3,1,5,2,8,1,1,0,0,15545,6.6,17186,229,44,1656,453,22.9,1554.5
4458767529,1,21,0,0,8,8,6,2,1,1,0,17889,7.2,19337,235,60,1792,1300,23.5,1788.9,11,4,1,8,8,7,0,0,0,0,16097,7.0,18037,180,48,-1792,-1300,18.0,1609.7
4451821740,0,13,4,0,5,6,7,1,1,0,0,15880,7.2,18313,219,64,-1891,263,21.9,1588.0,14,3,1,6,5,4,0,0,0,1,17771,7.0,18050,236,56,1891,-263,23.6,1777.1
4522799084,1,16,3,0,6,6,4,1,0,1,0,16576,7.0,18349,220,36,-316,63,22.0,1657.6,17,4,1,6,6,5,0,0,0,0,16892,7.0,18286,214,50,316,-63,21.4,1689.2
4525945440,0,15,4,0,4,9,7,1,1,0,0,15315,7.0,17674,188,62,-2881,-981,18.8,1531.5,18,4,1,9,4,11,1,0,1,0,18196,7.0,18655,230,39,2881,981,23.0,1819.6
4522215186,0,19,4,1,3,6,3,1,0,1,0,15417,6.8,16990,224,56,-691,-666,22.4,1541.7,17,4,0,6,3,11,1,1,0,0,16108,6.8,17656,213,48,691,666,21.3,1610.8
4502676809,0,68,2,1,13,3,19,1,0,1,0,17529,6.8,17038,138,40,1530,-1195,13.8,1752.9,17,5,0,3,13,2,1,1,0,0,15999,6.8,18233,243,63,-1530,1195,24.3,1599.9
4503986448,0,18,4,1,7,4,5,0,0,0,0,16681,7.0,18270,265,39,1403,389,26.5,1668.1,44,4,0,4,7,5,0,0,0,0,15278,7.0,17881,224,35,-1403,-389,22.4,1527.8
4511072676,0,19,6,0,5,4,6,1,1,0,0,16534,7.2,18294,260,44,131,-613,26.0,1653.4,31,3,1,4,5,5,0,0,0,0,16403,7.0,18907,233,64,-131,613,23.3,1640.3
4519672552,0,29,3,0,9,7,10,0,0,0,0,17126,6.8,17604,195,52,1386,679,19.5,1712.6,18,2,1,7,9,4,1,1,0,0,15740,6.6,16925,202,48,-1386,-679,20.2,1574.0
4477368808,1,14,3,0,5,4,9,2,1,1,0,16364,7.4,19838,245,60,409,1681,24.5,1636.4,13,4,1,4,5,3,0,0,0,0,15955,6.8,18157,229,60,-409,-1681,22.9,1595.5
4508148812,1,15,2,0,6,6,8,1,1,0,0,16820,6.8,17746,221,44,472,426,22.1,1682.0,14,2,1,6,6,7,0,0,0,0,16348,6.8,17320,185,55,-472,-426,18.5,1634.8
4523058868,0,15,5,0,5,5,7,0,0,0,0,15799,7.0,17703,225,49,56,-694,22.5,1579.9,37,2,1,5,5,4,1,1,0,0,15743,7.2,18397,208,59,-56,694,20.8,1574.3
4511977578,0,17,1,0,2,10,0,1,0,1,0,14311,6.8,17028,217,56,-5821,-3230,21.7,1431.1,43,5,1,10,2,11,1,1,0,1,20132,7.2,20258,251,68,5821,3230,25.1,2013.2
4517507679,0,86,1,0,6,11,5,0,0,0,0,15214,7.0,17796,171,48,-3709,-1635,17.1,1521.4,18,1,1,11,6,10,0,0,0,0,18923,7.2,19431,228,40,3709,1635,22.8,1892.3
4505847017,1,35,6,0,7,5,6,0,0,0,0,16555,7.2,18712,204,57,201,303,20.4,1655.5,45,7,1,5,7,6,1,1,0,0,16354,7.2,18409,210,64,-201,-303,21.0,1635.4
4518564856,0,15,1,0,6,9,5,0,0,0,0,15773,7.0,18578,228,44,-2069,-22,22.8,1577.3,13,1,1,9,6,11,1,1,0,0,17842,7.0,18600,222,56,2069,22,22.2,1784.2
4525139082,1,18,3,0,7,6,9,0,0,0,0,16711,6.6,17570,207,48,259,-527,20.7,1671.1,14,3,1,6,7,3,0,0,0,0,16452,6.8,18097,221,51,-259,527,22.1,1645.2
4456819413,0,29,3,0,5,7,8,0,0,0,0,15796,6.6,17121,184,49,-1044,-487,18.4,1579.6,18,2,1,7,5,11,1,1,0,0,16840,7.0,17608,226,49,1044,487,22.6,1684.0
4523319289,1,13,2,0,3,5,5,1,1,0,0,15597,7.2,18348,249,55,200,532,24.9,1559.7,10,1,1,5,3,2,0,0,0,0,15397,7.0,17816,203,60,-200,-532,20.3,1539.7
4525199033,1,40,2,1,13,6,14,0,0,0,0,18676,7.0,18018,196,44,3188,2289,19.6,1867.6,13,5,0,6,13,5,0,0,0,0,15488,6.4,15729,164,28,-3188,-2289,16.4,1548.8
4512777907,1,19,2,1,6,4,2,1,1,0,0,16476,7.0,18421,238,64,-323,345,23.8,1647.6,18,5,0,4,6,10,0,0,0,0,16799,7.0,18076,231,60,323,-345,23.1,1679.9
4522649114,1,23,5,1,5,2,9,0,0,0,0,15904,7.0,17670,213,48,1085,-556,21.3,1590.4,20,2,0,2,5,1,0,0,0,0,14819,6.8,18226,229,64,-1085,556,22.9,1481.9
4465999094,1,13,0,1,5,3,6,0,0,0,0,15284,6.6,16690,187,51,-480,-607,18.7,1528.4,15,1,0,3,5,3,1,1,0,0,15764,6.6,17297,230,60,480,607,23.0,1576.4
4510298547,1,17,1,1,12,4,19,1,1,0,0,18377,6.8,17762,193,50,2963,141,19.3,1837.7,15,2,0,4,12,1,0,0,0,0,15414,7.0,17621,221,47,-2963,-141,22.1,1541.4
4471961909,0,14,1,0,6,5,3,1,0,1,0,17039,7.2,18571,228,68,1008,372,22.8,1703.9,38,1,1,5,6,3,0,0,0,0,16031,6.8,18199,218,48,-1008,-372,21.8,1603.1
4474784540,0,48,3,1,3,10,1,0,0,0,0,14555,6.6,16626,200,52,-4431,-4570,20.0,1455.5,89,1,0,10,3,12,1,1,0,0,18986,7.6,21196,251,68,4431,4570,25.1,1898.6
4488272023,1,40,4,0,7,4,6,0,0,0,0,16972,7.2,19381,222,57,1992,3174,22.2,1697.2,16,6,1,4,7,6,1,1,0,0,14980,6.4,16207,221,36,-1992,-3174,22.1,1498.0
4500335888,1,14,2,0,7,4,5,1,1,0,0,17052,7.2,19250,234,64,1648,1881,23.4,1705.2,16,3,1,4,7,4,0,0,0,0,15404,6.6,17369,223,38,-1648,-1881,22.3,1540.4
4478447096,0,16,1,1,8,8,9,0,0,0,0,17057,6.6,17009,190,48,240,-903,19.0,1705.7,17,2,0,8,8,9,0,0,0,0,16817,7.0,17912,197,51,-240,903,19.7,1681.7
4521180188,1,13,2,0,3,3,2,1,1,0,0,15188,7.0,17748,236,57,52,1036,23.6,1518.8,14,1,1,3,3,3,0,0,0,0,15136,6.6,16712,214,55,-52,-1036,21.4,1513.6
4509303236,1,13,2,0,6,6,9,1,1,0,0,16239,7.0,18439,203,52,36,-234,20.3,1623.9,19,3,1,6,6,3,0,0,0,0,16203,7.2,18673,224,50,-36,234,22.4,1620.3
4487632164,1,17,5,1,11,7,12,0,0,0,0,19308,7.2,18764,243,49,2036,2183,24.3,1930.8,17,2,0,7,11,9,0,0,0,0,17272,6.6,16581,164,44,-2036,-2183,16.4,1727.2
4525358270,0,15,2,0,10,15,11,0,0,0,0,17318,7.0,17449,212,52,-3075,-2008,21.2,1731.8,12,4,1,15,10,16,2,1,1,0,20393,7.4,19457,214,52,3075,2008,21.4,2039.3
4525352224,1,129,17,0,6,6,6,1,1,0,0,16666,6.8,17512,185,58,132,-28,18.5,1666.6,47,1,1,6,6,6,0,0,0,0,16534,6.8,17540,237,40,-132,28,23.7,1653.4
4500875626,1,18,4,0,8,7,8,0,0,0,0,17219,7.2,18432,212,60,-55,-298,21.2,1721.9,18,4,1,7,8,7,1,1,0,0,17274,7.0,18730,251,59,55,298,25.1,1727.4
4450504768,0,22,3,0,0,5,0,0,0,0,0,13643,7.0,16820,217,62,-3585,-3405,21.7,1364.3,18,4,1,5,0,6,1,1,0,0,17228,7.4,20225,266,68,3585,3405,26.6,1722.8
4521440025,0,17,4,1,4,4,4,0,0,0,0,14788,6.6,17212,212,46,-516,-113,21.2,1478.8,38,3,0,4,4,5,1,1,0,0,15304,6.6,17325,212,47,516,113,21.2,1530.4
4523048704,1,19,4,1,10,6,10,1,1,0,0,18013,7.2,18223,228,51,1446,-143,22.8,1801.3,18,5,0,6,10,5,0,0,0,0,16567,7.0,18366,216,63,-1446,143,21.6,1656.7
4505526199,0,14,1,0,3,4,1,0,0,0,0,15087,7.0,17316,250,48,-523,-224,25.0,1508.7,14,1,1,4,3,7,0,0,0,0,15610,6.8,17540,203,52,523,224,20.3,1561.0
4477975030,0,19,3,1,5,4,5,0,0,0,0,16157,6.8,17603,240,28,804,365,24.0,1615.7,14,2,0,4,5,4,0,0,0,0,15353,7.0,17238,206,52,-804,-365,20.6,1535.3
4494766750,1,68,2,1,9,3,16,0,0,0,0,17718,7.0,18091,209,48,3017,1450,20.9,1771.8,17,2,0,3,9,2,0,0,0,0,14701,6.8,16641,197,52,-3017,-1450,19.7,1470.1
4526476556,1,15,3,1,7,6,6,0,0,0,0,16946,7.4,19649,221,76,714,1650,22.1,1694.6,12,5,0,6,7,7,0,0,0,0,16232,6.8,17999,215,58,-714,-1650,21.5,1623.2
4518948833,1,25,5,1,6,5,9,1,1,0,0,15401,6.6,16508,195,32,-729,-889,19.5,1540.1,18,2,0,5,6,5,0,0,0,0,16130,6.6,17397,191,51,729,889,19.1,1613.0
4516264231,1,17,4,1,5,9,8,0,0,0,0,16426,7.0,18382,231,60,-642,-397,23.1,1642.6,16,3,0,9,5,6,1,1,0,0,17068,7.0,18779,193,59,642,397,19.3,1706.8
4489107680,0,17,3,1,8,7,9,0,0,0,0,17164,7.0,18932,222,55,525,902,22.2,1716.4,17,0,0,7,8,7,0,0,0,0,16639,6.8,18030,215,55,-525,-902,21.5,1663.9
4523726698,0,20,22,0,3,11,7,0,0,0,0,13511,5.8,14048,164,39,-5427,-4559,16.4,1351.1,40,3,1,11,3,14,1,1,0,0,18938,7.2,18607,239,57,5427,4559,23.9,1893.8
4519991691,0,61,0,1,3,13,4,0,0,0,0,13908,5.4,12798,167,38,-4561,-5031,16.7,1390.8,16,2,0,13,3,20,1,1,0,0,18469,7.0,17829,187,58,4561,5031,18.7,1846.9
4524583586,1,13,1,0,4,6,2,0,0,0,0,14687,6.6,16647,216,32,-2142,-1742,21.6,1468.7,17,1,1,6,4,5,1,1,0,0,16829,6.8,18389,223,75,2142,1742,22.3,1682.9
4520353212,1,15,2,0,6,4,8,0,0,0,0,17201,7.2,19652,239,57,1820,1893,23.9,1720.1,12,2,1,4,6,5,1,1,0,0,15381,7.0,17759,219,58,-1820,-1893,21.9,1538.1
4482905439,1,14,0,0,6,3,7,1,1,0,0,15464,6.8,17053,219,32,679,-691,21.9,1546.4,16,1,1,3,6,2,1,0,1,0,14785,6.8,17744,220,44,-679,691,22.0,1478.5
4521091786,0,15,0,1,6,9,5,1,0,1,0,16525,6.8,18095,204,47,-1782,-972,20.4,1652.5,18,3,0,9,6,11,1,1,0,0,18307,7.2,19067,217,67,1782,972,21.7,1830.7
4520898233,0,78,4,0,4,3,4,2,1,1,0,15906,6.8,19219,238,67,406,1283,23.8,1590.6,15,3,1,3,4,3,0,0,0,0,15500,7.0,17936,220,64,-406,-1283,22.0,1550.0
4522819691,0,37,2,0,5,4,3,0,0,0,0,16021,7.2,19551,216,60,-470,1524,21.6,1602.1,16,1,1,4,5,4,0,0,0,0,16491,6.8,18027,237,50,470,-1524,23.7,1649.1
4522592356,1,18,5,1,8,3,5,0,0,0,0,16818,7.0,18454,231,45,3138,2806,23.1,1681.8,16,1,0,3,8,0,2,1,1,0,13680,6.4,15648,196,51,-3138,-2806,19.6,1368.0
4527270675,0,20,4,1,10,6,9,0,0,0,0,18344,7.2,18470,222,55,2326,987,22.2,1834.4,16,4,0,6,10,5,0,0,0,0,16018,7.0,17483,188,56,-2326,-987,18.8,1601.8
4481186047,1,19,2,0,7,10,9,1,1,0,0,16070,6.6,16577,173,36,-1156,-667,17.3,1607.0,16,4,1,10,7,6,0,0,0,0,17226,6.6,17244,211,42,1156,667,21.1,1722.6
4486520653,1,11,1,1,7,4,5,0,0,0,0,17052,6.8,17766,241,44,1475,-95,24.1,1705.2,36,2,0,4,7,5,1,1,0,0,15577,6.6,17861,206,60,-1475,95,20.6,1557.7
4519582751,0,40,4,1,4,7,4,0,0,0,0,15280,6.6,16650,202,47,-770,-1875,20.2,1528.0,17,16,0,7,4,4,1,1,0,0,16050,7.2,18525,217,51,770,1875,21.7,1605.0
4523414264,1,64,4,0,5,9,7,0,0,0,0,15220,6.4,16145,174,46,-3679,-3273,17.4,1522.0,11,5,1,9,5,11,0,0,0,0,18899,7.0,19418,266,64,3679,3273,26.6,1889.9
4509068036,0,15,3,1,4,0,2,0,0,0,0,16024,6.8,19005,220,62,3133,2377,22.0,1602.4,14,2,0,0,4,0,0,0,0,0,12891,6.6,16628,206,44,-3133,-2377,20.6,1289.1
4515777597,1,22,5,1,12,7,20,1,1,0,0,19070,7.0,17872,210,56,2247,1367,21.0,1907.0,17,6,0,7,12,9,0,0,0,0,16823,6.6,16505,205,38,-2247,-1367,20.5,1682.3
4506595531,1,15,2,1,5,4,5,0,0,0,0,14797,6.6,16703,195,40,-1576,-1720,19.5,1479.7,15,2,0,4,5,2,1,1,0,0,16373,6.8,18423,259,48,1576,1720,25.9,1637.3
4415032113,0,18,3,0,3,12,6,0,0,0,0,13961,6.2,14440,168,25,-4731,-2817,16.8,1396.1,20,7,1,12,3,21,0,0,0,0,18692,6.8,17257,206,42,4731,2817,20.6,1869.2
4452789398,1,27,0,0,5,3,7,0,0,0,0,16239,7.2,18466,189,60,906,1767,18.9,1623.9,11,3,1,3,5,3,1,1,0,0,15333,6.6,16699,221,60,-906,-1767,22.1,1533.3
4523251665,0,48,3,0,3,6,6,0,0,0,0,14986,6.8,17222,208,46,-1501,-1478,20.8,1498.6,18,3,1,6,3,4,0,0,0,0,16487,7.2,18700,220,49,1501,1478,22.0,1648.7
4524635959,0,18,3,0,6,6,6,1,1,0,0,15571,6.8,16898,190,60,-1137,-982,19.0,1557.1,17,1,1,6,6,5,1,0,1,0,16708,7.0,17880,228,52,1137,982,22.8,1670.8
4523968738,1,15,5,1,9,9,7,0,0,0,0,17225,7.0,17613,217,38,69,-232,21.7,1722.5,13,4,0,9,9,12,0,0,0,0,17156,7.0,17845,210,32,-69,232,21.0,1715.6
4500758872,0,11,0,0,4,8,6,0,0,0,0,14327,6.6,16104,194,30,-3392,-2116,19.4,1432.7,15,2,1,8,4,7,1,1,0,0,17719,6.8,18220,223,41,3392,2116,22.3,1771.9
4527650398,1,12,0,1,7,7,9,0,0,0,0,17155,7.0,18002,231,36,756,1,23.1,1715.5,60,3,0,7,7,8,1,1,0,0,16399,7.0,18001,216,58,-756,-1,21.6,1639.9
4475474933,1,14,4,1,8,4,7,0,0,0,1,17634,6.8,17330,219,45,1930,425,21.9,1763.4,17,1,0,4,8,5,0,0,0,0,15704,6.4,16905,226,46,-1930,-425,22.6,1570.4
4526047825,1,68,4,1,8,6,10,1,1,0,0,16912,6.8,17195,205,52,1051,797,20.5,1691.2,17,0,0,6,8,8,0,0,0,0,15861,6.6,16398,212,36,-1051,-797,21.2,1586.1
4520801995,0,17,2,0,2,10,1,0,0,0,0,15239,7.0,18073,232,52,-3449,-1995,23.2,1523.9,17,0,1,10,2,13,1,1,0,0,18688,7.6,20068,231,57,3449,1995,23.1,1868.8
4519840104,1,18,4,1,7,3,6,0,0,0,1,18100,7.0,18030,197,48,2690,236,19.7,1810.0,15,3,0,3,7,3,1,0,1,0,15410,6.8,17794,211,60,-2690,-236,21.1,1541.0
4522475843,1,11,0,1,3,5,3,2,1,1,0,15562,6.8,16991,222,52,-1176,-1838,22.2,1556.2,16,2,0,5,3,9,0,0,0,0,16738,7.0,18829,201,68,1176,1838,20.1,1673.8
4494136830,0,15,1,1,5,3,6,1,1,0,0,16224,6.8,18284,254,53,586,348,25.4,1622.4,16,1,0,3,5,3,0,0,0,0,15638,6.8,17936,245,50,-586,-348,24.5,1563.8
4521258257,1,18,6,1,4,4,3,0,0,0,0,15936,6.8,16572,229,44,218,-1933,22.9,1593.6,42,5,0,4,4,5,1,1,0,0,15718,7.0,18505,243,52,-218,1933,24.3,1571.8
4474915935,1,26,8,1,9,10,7,1,1,0,0,18410,7.2,18561,253,51,714,-176,25.3,1841.0,13,7,0,10,9,10,0,0,0,0,17696,7.0,18737,232,40,-714,176,23.2,1769.6
4522358340,0,21,3,1,11,10,6,0,0,0,0,17183,7.0,18197,208,44,157,1673,20.8,1718.3,17,4,0,10,11,14,1,1,0,0,17026,6.8,16524,188,41,-157,-1673,18.8,1702.6
4523527699,1,108,5,1,6,5,8,0,0,0,0,16620,7.0,17711,238,37,361,-672,23.8,1662.0,17,0,0,5,6,5,0,0,0,0,16259,7.0,18383,223,54,-361,672,22.3,1625.9
4476138095,1,51,3,0,4,6,7,0,0,0,0,15766,6.8,16923,213,47,-856,-642,21.3,1576.6,16,3,1,6,4,6,1,1,0,0,16622,6.6,17565,239,58,856,642,23.9,1662.2
4515353757,1,15,3,0,1,2,1,1,1,0,0,14836,7.0,18769,261,60,-425,-316,26.1,1483.6,64,2,1,2,1,2,0,0,0,0,15261,7.2,19085,255,64,425,316,25.5,1526.1
4491049455,0,16,4,0,5,11,6,0,0,0,0,15424,6.6,16080,208,45,-3692,-3112,20.8,1542.4,14,4,1,11,5,16,2,1,1,0,19116,7.2,19192,195,55,3692,3112,19.5,1911.6
4524145810,1,17,6,1,10,8,12,1,1,0,0,17756,7.0,18320,201,40,-145,-28,20.1,1775.6,21,3,0,8,10,5,0,0,0,0,17901,7.0,18348,219,59,145,28,21.9,1790.1
4515648719,0,46,2,1,11,8,13,0,0,0,0,16886,6.6,16618,172,39,-2107,-1458,17.2,1688.6,14,0,0,8,11,8,1,1,0,0,18993,7.2,18076,189,60,2107,1458,18.9,1899.3
4459463690,1,15,6,0,4,4,5,1,1,0,0,15676,7.0,19069,231,61,-261,443,23.1,1567.6,59,1,1,4,4,8,1,0,1,0,15937,6.8,18626,231,56,261,-443,23.1,1593.7
4524116491,1,12,2,0,5,9,8,0,0,0,0,16095,6.8,17192,222,50,-1905,-2185,22.2,1609.5,13,0,1,9,5,12,0,0,0,0,18000,7.2,19377,217,64,1905,2185,21.7,1800.0
4516594125,1,14,3,0,7,3,8,1,1,0,0,16858,7.0,18658,228,40,1160,1541,22.8,1685.8,22,4,1,3,7,6,0,0,0,0,15698,6.6,17117,244,58,-1160,-1541,24.4,1569.8
4521052403,1,15,1,1,8,3,6,0,0,0,0,17263,7.2,19913,234,65,3181,3298,23.4,1726.3,11,2,0,3,8,3,2,1,1,0,14082,6.8,16615,159,51,-3181,-3298,15.9,1408.2
4518463691,1,20,4,1,7,0,11,1,1,0,0,16942,6.6,17249,214,48,3843,2831,21.4,1694.2,12,3,0,0,7,0,0,0,0,0,13099,6.2,14418,191,46,-3843,-2831,19.1,1309.9
4455312963,1,13,2,1,11,7,11,0,0,0,0,17662,7.2,18294,195,24,1673,536,19.5,1766.2,47,0,0,7,11,5,1,0,1,0,15989,7.0,17758,173,63,-1673,-536,17.3,1598.9
4463067805,1,16,2,0,6,5,3,1,1,0,0,16912,7.0,19261,253,60,750,1293,25.3,1691.2,17,3,1,5,6,3,0,0,0,0,16162,7.0,17968,233,40,-750,-1293,23.3,1616.2
4503585743,0,13,0,0,4,3,5,0,0,0,0,15260,7.0,17619,191,59,323,701,19.1,1526.0,89,2,1,3,4,0,2,1,1,0,14937,6.6,16918,212,52,-323,-701,21.2,1493.7
4525583733,1,20,21,1,4,4,7,0,0,0,0,15582,6.4,15958,238,43,977,134,23.8,1558.2,42,2,0,4,4,7,1,1,0,0,14605,6.4,15824,204,36,-977,-134,20.4,1460.5
4460653436,0,40,1,0,5,11,8,0,0,0,0,16177,7.0,18425,224,45,-1546,-710,22.4,1617.7,15,6,1,11,5,12,1,1,0,0,17723,7.4,19135,183,58,1546,710,18.3,1772.3
4524424547,1,16,1,1,6,0,7,2,1,1,0,16874,7.2,19010,260,51,2929,2507,26.0,1687.4,16,2,0,0,6,0,0,0,0,0,13945,6.6,16503,239,52,-2929,-2507,23.9,1394.5
4462163208,1,43,1,0,9,8,11,1,1,0,0,16982,7.0,18420,191,44,-1346,-1607,19.1,1698.2,15,0,1,8,9,7,0,0,0,0,18328,7.4,20027,212,76,1346,1607,21.2,1832.8
4459418166,0,15,4,0,9,6,8,0,0,0,0,17807,7.4,19554,229,46,1233,336,22.9,1780.7,80,1,1,6,9,5,2,1,1,0,16574,7.4,19218,197,53,-1233,-336,19.7,1657.4
4524576336,1,47,3,0,10,8,12,1,1,0,0,17342,7.0,17885,179,48,-447,-955,17.9,1734.2,13,0,1,8,10,5,0,0,0,0,17789,7.2,18840,206,44,447,955,20.6,1778.9
4471506446,1,22,2,1,18,4,14,2,1,1,0,21416,7.6,21031,235,57,7482,6466,23.5,2141.6,16,0,0,4,18,3,0,0,0,0,13934,6.0,14565,144,39,-7482,-6466,14.4,1393.4
4460106105,0,15,3,0,4,6,2,0,0,0,0,15009,6.4,16571,211,44,-1806,-1419,21.1,1500.9,21,4,1,6,4,7,2,1,1,0,16815,7.0,17990,220,59,1806,1419,22.0,1681.5
4477273718,1,14,1,1,4,2,4,0,0,0,0,15843,7.2,18349,236,47,1284,395,23.6,1584.3,17,3,0,2,4,1,1,1,0,0,14559,7.0,17954,204,64,-1284,-395,20.4,1455.9
4502875704,0,16,2,0,1,10,2,1,0,1,0,14727,6.6,16272,219,52,-3581,-2467,21.9,1472.7,14,6,1,10,1,15,1,1,0,0,18308,7.0,18739,248,31,3581,2467,24.8,1830.8
4525208534,0,16,2,0,2,5,1,0,0,0,0,14182,6.8,16753,220,52,-1700,-1053,22.0,1418.2,12,2,1,5,2,3,0,0,0,0,15882,6.8,17806,223,43,1700,1053,22.3,1588.2
4514314077,0,15,2,0,5,7,6,0,0,0,0,15888,7.0,18305,239,47,-1157,-51,23.9,1588.8,14,4,1,7,5,7,1,0,1,0,17045,7.0,18356,216,56,1157,51,21.6,1704.5
4519026999,1,37,4,0,8,6,7,0,0,0,0,16894,7.0,17731,205,38,1797,1094,20.5,1689.4,49,3,1,6,8,5,1,1,0,0,15097,6.6,16637,190,42,-1797,-1094,19.0,1509.7
4507803144,0,17,2,0,2,9,2,0,0,0,0,13889,6.4,16133,200,52,-4479,-2696,20.0,1388.9,13,4,1,9,2,12,0,0,0,0,18368,7.0,18829,239,48,4479,2696,23.9,1836.8
4527366707,1,18,2,0,7,2,10,0,0,0,0,16879,7.2,18526,211,52,2053,1126,21.1,1687.9,15,3,1,2,7,3,1,1,0,0,14826,6.8,17400,232,64,-2053,-1126,23.2,1482.6
4448127170,0,34,7,1,2,3,3,1,0,1,0,15345,7.2,18848,230,64,-164,1358,23.0,1534.5,19,3,0,3,2,7,1,1,0,0,15509,6.6,17490,236,55,164,-1358,23.6,1550.9
4488944562,1,18,5,1,4,5,7,0,0,0,0,15340,6.6,16902,213,43,-885,-1554,21.3,1534.0,18,7,0,5,4,5,2,1,1,0,16225,7.2,18456,240,60,885,1554,24.0,1622.5
4492308589,0,15,5,1,5,8,6,0,0,0,0,15627,6.8,17457,199,56,-2690,-3245,19.9,1562.7,58,1,0,8,5,9,2,1,1,0,18317,7.6,20702,230,92,2690,3245,23.0,1831.7
4522240488,0,18,5,0,3,3,7,1,1,0,0,14742,6.6,16390,202,57,-1517,-1565,20.2,1474.2,16,4,1,3,3,5,0,0,0,0,16259,7.0,17955,255,49,1517,1565,25.5,1625.9
4474977192,0,16,1,0,5,11,4,0,0,0,0,16105,6.8,17502,214,35,-2047,-2555,21.4,1610.5,141,1,1,11,5,5,1,1,0,0,18152,7.6,20057,208,52,2047,2555,20.8,1815.2
4463528314,1,17,1,0,9,6,12,0,0,0,0,17752,7.0,18405,212,47,1512,447,21.2,1775.2,12,6,1,6,9,6,1,1,0,0,16240,7.0,17958,219,52,-1512,-447,21.9,1624.0
4494587066,0,14,1,0,6,7,7,1,0,1,1,17927,6.8,18100,213,45,396,-1813,21.3,1792.7,36,2,1,7,6,8,1,1,0,0,17531,7.4,19913,229,73,-396,1813,22.9,1753.1
4523959308,0,18,4,1,10,7,7,1,1,0,0,18185,7.0,19320,213,56,1340,1318,21.3,1818.5,30,3,0,7,10,4,0,0,0,0,16845,6.8,18002,216,56,-1340,-1318,21.6,1684.5
4518835789,1,22,6,1,7,3,6,1,1,0,0,19140,7.4,19579,253,64,5008,2355,25.3,1914.0,60,6,0,3,7,3,1,0,1,0,14132,6.8,17224,179,45,-5008,-2355,17.9,1413.2
4516600859,0,18,1,1,4,1,4,1,0,1,1,16808,6.8,17831,227,46,2476,772,22.7,1680.8,15,2,0,1,4,0,1,1,0,0,14332,6.8,17059,248,53,-2476,-772,24.8,1433.2
4511761586,1,45,5,0,6,7,8,1,1,0,0,17046,7.4,19783,217,67,307,2085,21.7,1704.6,16,7,1,7,6,7,0,0,0,0,16739,7.0,17698,256,40,-307,-2085,25.6,1673.9
4522394402,0,19,2,1,9,9,12,1,1,0,0,17187,7.0,17605,197,38,-1675,-1382,19.7,1718.7,16,1,0,9,9,11,1,0,1,0,18862,7.2,18987,206,40,1675,1382,20.6,1886.2
4506279067,0,13,5,0,2,7,1,0,0,0,0,13946,6.4,16248,227,22,-2727,-2041,22.7,1394.6,19,5,1,7,2,10,1,1,0,0,16673,7.0,18289,220,58,2727,2041,22.0,1667.3
4497057886,0,15,2,0,1,8,2,1,1,0,0,14702,6.6,16461,214,55,-5136,-3713,21.4,1470.2,14,3,1,8,1,7,0,0,0,1,19838,7.6,20174,289,46,5136,3713,28.9,1983.8
4515886739,1,12,4,0,8,4,15,0,0,0,0,16894,7.2,18333,219,40,1077,1096,21.9,1689.4,16,1,1,4,8,4,0,0,0,0,15817,6.8,17237,208,63,-1077,-1096,20.8,1581.7
4427765980,0,40,3,0,5,6,7,0,0,0,0,15628,7.0,17683,221,49,-623,-39,22.1,1562.8,18,5,1,6,5,6,1,1,0,0,16251,6.8,17722,223,42,623,39,22.3,1625.1
4502562701,1,16,2,1,8,7,6,2,1,1,0,17867,7.2,19316,226,76,764,2490,22.6,1786.7,16,3,0,7,8,6,0,0,0,0,17103,6.6,16826,178,59,-764,-2490,17.8,1710.3
4524403652,1,12,2,1,7,6,5,1,1,0,0,17051,7.0,18864,246,44,1909,2436,24.6,1705.1,16,0,0,6,7,8,0,0,0,0,15142,6.4,16428,196,40,-1909,-2436,19.6,1514.2
4494408624,1,42,5,0,13,13,14,0,0,0,0,19580,7.0,18977,201,45,935,2197,20.1,1958.0,13,3,1,13,13,14,0,0,0,0,18645,6.6,16780,179,32,-935,-2197,17.9,1864.5
4457538787,0,19,1,0,2,1,3,1,1,0,0,14494,6.8,18008,244,47,-618,-413,24.4,1449.4,38,4,1,1,2,2,0,0,0,0,15112,6.8,18421,247,60,618,413,24.7,1511.2
4527293021,1,10,7,1,5,3,5,1,1,0,0,15239,7.2,18919,218,45,742,2904,21.8,1523.9,22,2,0,3,5,4,0,0,0,0,14497,6.6,16015,182,58,-742,-2904,18.2,1449.7
4473252742,0,14,0,0,7,9,5,0,0,0,0,16474,6.6,17408,209,50,-1559,-407,20.9,1647.4,22,4,1,9,7,13,1,1,0,0,18033,6.8,17815,206,53,1559,407,20.6,1803.3
4478167956,1,13,1,0,14,2,19,1,1,0,0,19133,7.2,19406,200,56,4531,2978,20.0,1913.3,12,2,1,2,14,3,0,0,0,0,14602,6.6,16428,211,60,-4531,-2978,21.1,1460.2
4514424102,1,16,2,0,6,3,5,1,1,0,0,15690,6.8,17299,214,44,903,1110,21.4,1569.0,13,2,1,3,6,3,0,0,0,0,14787,6.8,16189,199,52,-903,-1110,19.9,1478.7
4458570430,1,18,2,1,4,5,5,1,1,0,0,16086,6.8,17616,222,56,842,-663,22.2,1608.6,17,0,0,5,4,5,0,0,0,0,15244,7.0,18279,201,44,-842,663,20.1,1524.4
4524458385,1,16,7,1,5,5,5,0,0,0,0,15722,6.8,16349,222,34,679,471,22.2,1572.2,16,3,0,5,5,5,0,0,0,0,15043,6.4,15878,181,48,-679,-471,18.1,1504.3
4450233213,1,13,5,1,4,6,4,0,0,0,1,17814,7.0,18330,252,56,2154,25,25.2,1781.4,14,1,0,6,4,4,1,0,1,0,15660,7.0,18305,197,48,-2154,-25,19.7,1566.0
4522148176,1,35,1,0,7,3,6,2,1,1,0,17555,7.8,20887,248,63,2678,3150,24.8,1755.5,15,1,1,3,7,3,0,0,0,0,14877,7.0,17737,200,58,-2678,-3150,20.0,1487.7
4497602150,1,16,6,0,5,4,10,1,1,0,0,15387,7.0,17708,174,66,337,1346,17.4,1538.7,22,5,1,4,5,4,0,0,0,0,15050,6.8,16362,213,48,-337,-1346,21.3,1505.0
4467510669,1,19,4,1,9,7,10,0,0,0,0,17556,7.0,18073,220,41,1253,-235,22.0,1755.6,16,7,0,7,9,4,0,0,0,0,16303,7.0,18308,191,68,-1253,235,19.1,1630.3
4451870121,1,35,5,0,11,3,12,1,1,0,0,18929,7.4,19632,220,55,4175,3930,22.0,1892.9,16,2,1,3,11,3,1,0,1,0,14754,6.6,15702,201,44,-4175,-3930,20.1,1475.4
4501779329,0,16,4,1,6,5,7,1,0,1,0,16113,6.8,16994,180,41,-1063,-632,18.0,1611.3,18,4,0,5,6,5,0,0,0,1,17176,6.8,17626,240,41,1063,632,24.0,1717.6
4518199999,1,14,1,1,6,4,3,1,1,0,0,16434,7.0,18641,228,47,1085,1048,22.8,1643.4,12,2,0,4,6,2,0,0,0,0,15349,6.6,17593,220,48,-1085,-1048,22.0,1534.9
4521285475,0,16,3,1,11,8,11,1,1,0,0,19239,7.6,19698,209,47,2587,1759,20.9,1923.9,14,2,0,8,11,4,0,0,0,0,16652,6.8,17939,195,44,-2587,-1759,19.5,1665.2
4527181614,1,16,2,1,10,8,10,0,0,0,0,17665,6.8,17473,207,44,753,-587,20.7,1766.5,16,4,0,8,10,6,0,0,0,0,16912,6.8,18060,191,45,-753,587,19.1,1691.2
4520348374,1,24,3,1,6,6,12,0,0,0,1,17552,6.8,16611,201,45,1189,-821,20.1,1755.2,97,5,0,6,6,5,1,0,1,0,16363,6.8,17432,191,55,-1189,821,19.1,1636.3
4521266857,0,18,4,1,3,6,1,0,0,0,0,15177,6.8,17645,220,52,-1716,-2811,22.0,1517.7,21,1,0,6,3,4,0,0,0,0,16893,7.4,20456,241,64,1716,2811,24.1,1689.3
4507176171,0,18,3,0,4,4,6,0,0,0,0,15089,6.8,17046,213,40,-494,-817,21.3,1508.9,20,6,1,4,4,4,2,1,1,0,15583,6.8,17863,216,61,494,817,21.6,1558.3
4512893188,0,17,0,1,8,10,8,0,0,0,0,17180,6.8,17696,216,42,-1249,-1518,21.6,1718.0,20,3,0,10,8,10,1,1,0,0,18429,7.4,19214,183,54,1249,1518,18.3,1842.9
4516905603,1,15,1,0,7,8,8,0,0,0,1,18283,7.0,18662,209,60,905,312,20.9,1828.3,15,3,1,8,7,6,1,1,0,0,17378,7.0,18350,206,61,-905,-312,20.6,1737.8
4456733355,0,13,5,1,5,10,7,0,0,0,0,15135,6.8,16444,197,41,-3704,-4361,19.7,1513.5,38,4,0,10,5,12,1,1,0,0,18839,7.6,20805,244,72,3704,4361,24.4,1883.9
4518963809,1,12,4,1,9,8,10,0,0,0,0,17216,6.6,17264,207,48,1462,1290,20.7,1721.6,39,4,0,8,9,9,0,0,0,0,15754,6.4,15974,165,39,-1462,-1290,16.5,1575.4
4519740726,0,14,1,1,6,7,5,0,0,0,0,16688,6.8,17793,213,44,-214,-334,21.3,1668.8,36,2,0,7,6,8,1,1,0,0,16902,7.0,18127,201,71,214,334,20.1,1690.2
4512935450,0,12,2,0,6,13,10,1,0,1,0,16083,6.6,16509,218,52,-2772,-2957,21.8,1608.3,15,5,1,13,6,11,1,1,0,0,18855,7.2,19466,207,52,2772,2957,20.7,1885.5
4461601023,1,18,1,1,10,4,6,2,1,1,0,18288,7.6,20765,234,68,3184,3874,23.4,1828.8,14,1,0,4,10,5,0,0,0,0,15104,6.8,16891,209,54,-3184,-3874,20.9,1510.4
4519007166,1,19,2,1,8,9,7,2,1,1,0,15775,6.6,17200,149,47,-2675,-1325,14.9,1577.5,19,4,0,9,8,11,0,0,0,0,18450,7.0,18525,231,42,2675,1325,23.1,1845.0
4526067873,1,18,1,0,4,9,3,0,0,0,0,15162,6.8,17438,220,44,-3051,-2198,22.0,1516.2,48,2,1,9,4,8,2,1,1,0,18213,7.4,19636,250,53,3051,2198,25.0,1821.3
4498316560,0,17,2,1,8,5,9,1,1,0,0,17172,7.0,18972,196,60,1131,1145,19.6,1717.2,13,2,0,5,8,5,1,0,1,0,16041,6.8,17827,231,56,-1131,-1145,23.1,1604.1
4524504083,1,38,4,1,8,5,9,1,1,0,0,16646,7.0,17451,188,51,1308,1296,18.8,1664.6,16,1,0,5,8,7,1,0,1,0,15338,6.4,16155,227,40,-1308,-1296,22.7,1533.8
4496346599,0,19,3,0,6,8,9,1,1,0,0,15731,6.8,17396,236,37,-2238,-1138,23.6,1573.1,17,2,1,8,6,8,0,0,0,0,17969,7.2,18534,235,65,2238,1138,23.5,1796.9
4502515468,1,23,2,1,12,5,13,0,0,0,0,17307,6.4,16818,189,26,3237,2107,18.9,1730.7,14,0,0,5,12,4,0,0,0,0,14070,6.2,14711,158,33,-3237,-2107,15.8,1407.0
4522839923,1,15,4,1,3,5,6,1,1,0,0,16120,7.0,18058,246,53,-576,-1269,24.6,1612.0,88,1,0,5,3,6,1,0,1,0,16696,7.2,19327,228,59,576,1269,22.8,1669.6
4519014512,0,15,3,1,6,5,8,2,1,1,0,16997,6.8,17893,215,46,639,-401,21.5,1699.7,15,2,0,5,6,6,0,0,0,0,16358,6.8,18294,220,58,-639,401,22.0,1635.8
4506972533,0,9,0,1,2,5,3,1,1,0,0,14930,6.8,17328,231,61,-3418,-2689,23.1,1493.0,14,2,0,5,2,3,0,0,0,1,18348,7.4,20017,263,65,3418,2689,26.3,1834.8
4476285396,0,15,3,1,3,7,2,0,0,0,0,14756,6.6,16229,226,48,-2175,-2386,22.6,1475.6,15,3,0,7,3,9,0,0,0,0,16931,7.2,18615,233,50,2175,2386,23.3,1693.1
4521238149,1,18,6,0,3,2,1,0,0,0,0,15681,7.0,19274,231,52,919,1527,23.1,1568.1,53,7,1,2,3,2,1,1,0,0,14762,7.0,17747,230,58,-919,-1527,23.0,1476.2
4524047710,1,16,3,1,8,1,11,1,0,1,1,18976,7.2,19176,259,49,4910,2573,25.9,1897.6,20,2,0,1,8,0,1,1,0,0,14066,6.6,16603,224,43,-4910,-2573,22.4,1406.6
4519133834,0,16,2,0,6,16,6,1,1,0,0,14999,6.4,15530,192,44,-6027,-3955,19.2,1499.9,18,4,1,16,6,24,0,0,0,0,21026,7.4,19485,228,52,6027,3955,22.8,2102.6
4478381770,0,19,7,0,1,6,1,0,0,0,0,14910,6.8,17888,245,56,-1557,-1039,24.5,1491.0,16,7,1,6,1,7,1,1,0,0,16467,7.2,18927,225,56,1557,1039,22.5,1646.7
4503927654,0,77,4,0,2,7,2,0,0,0,0,13598,6.2,15349,189,45,-3892,-2725,18.9,1359.8,18,1,1,7,2,7,1,1,0,0,17490,7.0,18074,223,52,3892,2725,22.3,1749.0
4511051805,1,15,2,0,5,8,4,0,0,0,0,16697,7.0,18216,214,62,-63,-779,21.4,1669.7,37,3,1,8,5,4,1,1,0,0,16760,7.2,18995,219,58,63,779,21.9,1676.0
4511728953,1,15,2,0,4,5,3,1,1,0,0,15859,7.2,18390,242,59,-88,-932,24.2,1585.9,41,2,1,5,4,10,0,0,0,0,15947,7.2,19322,222,61,88,932,22.2,1594.7
4477478034,0,17,1,0,5,13,5,0,0,0,0,14642,6.2,15033,171,41,-4958,-2388,17.1,1464.2,29,4,1,13,5,14,1,1,0,0,19600,7.0,17421,231,24,4958,2388,23.1,1960.0
4526851644,1,56,1,0,12,4,13,0,0,0,0,18119,7.0,18951,198,48,4108,2927,19.8,1811.9,10,1,1,4,12,1,1,1,0,0,14011,6.4,16024,179,51,-4108,-2927,17.9,1401.1
4453066386,0,16,2,0,2,8,2,1,0,1,0,14786,6.6,16676,233,50,-1340,-529,23.3,1478.6,16,4,1,8,2,6,1,1,0,0,16126,6.8,17205,205,37,1340,529,20.5,1612.6
4523932560,1,20,3,0,9,5,8,2,1,1,0,17615,7.2,19117,218,48,2643,3340,21.8,1761.5,15,3,1,5,9,6,0,0,0,0,14972,6.4,15777,194,41,-2643,-3340,19.4,1497.2
4468741090,0,17,8,1,10,5,17,1,1,0,0,19190,7.2,18615,202,34,3386,2410,20.2,1919.0,18,3,0,5,10,8,1,0,1,0,15804,6.4,16205,224,48,-3386,-2410,22.4,1580.4
4454069388,0,41,4,1,7,8,8,0,0,0,0,16604,6.6,17328,203,47,-416,-907,20.3,1660.4,17,6,0,8,7,11,1,1,0,0,17020,7.0,18235,201,55,416,907,20.1,1702.0
4427951118,0,16,3,0,4,11,5,1,0,1,0,15372,6.8,17002,213,57,-2585,204,21.3,1537.2,18,2,1,11,4,12,1,1,0,0,17957,6.8,16798,209,40,2585,-204,20.9,1795.7
4505154902,1,44,1,1,10,2,13,1,1,0,0,17519,6.8,17753,209,37,4216,2141,20.9,1751.9,11,2,0,2,10,1,0,0,0,0,13303,6.4,15612,197,38,-4216,-2141,19.7,1330.3
4513836142,1,17,2,0,11,4,12,0,0,0,0,18173,7.0,18943,218,39,3036,1949,21.8,1817.3,10,1,1,4,11,4,0,0,0,0,15137,6.8,16994,203,40,-3036,-1949,20.3,1513.7
4516781152,0,12,4,1,7,4,5,1,1,0,0,17214,7.0,19173,235,48,1746,2273,23.5,1721.4,14,4,0,4,7,6,0,0,0,0,15468,6.8,16900,205,56,-1746,-2273,20.5,1546.8
4526272276,0,15,2,0,1,6,1,0,0,0,0,13409,6.6,15601,203,45,-3559,-3320,20.3,1340.9,12,1,1,6,1,4,2,1,1,0,16968,7.0,18921,236,69,3559,3320,23.6,1696.8
4455647637,0,10,5,0,2,10,3,0,0,0,0,14094,6.2,15768,197,57,-5521,-3591,19.7,1409.4,19,2,1,10,2,14,1,1,0,0,19615,7.4,19359,258,52,5521,3591,25.8,1961.5
4514548275,1,20,4,1,7,3,8,2,1,1,0,17507,7.2,19641,250,64,2790,3073,25.0,1750.7,169,2,0,3,7,3,0,0,0,0,14717,6.6,16568,209,47,-2790,-3073,20.9,1471.7
4523862114,1,22,3,0,7,2,4,1,1,0,0,16031,6.8,17458,218,55,1643,882,21.8,1603.1,21,3,1,2,7,0,0,0,0,0,14388,6.6,16576,225,48,-1643,-882,22.5,1438.8
4524014762,0,19,4,0,1,6,2,0,0,0,0,14307,6.4,16295,211,44,-3418,-3733,21.1,1430.7,17,3,1,6,1,5,2,1,1,0,17725,7.4,20028,234,72,3418,3733,23.4,1772.5
4459430310,0,14,4,0,0,5,0,1,0,1,0,13776,6.8,16664,218,60,-2765,-2677,21.8,1377.6,19,3,1,5,0,6,1,1,0,0,16541,7.2,19341,256,53,2765,2677,25.6,1654.1
4466191823,0,15,6,0,8,4,9,1,1,0,0,16804,7.2,18899,206,60,2290,1865,20.6,1680.4,10,2,1,4,8,2,0,0,0,0,14514,6.6,17034,180,40,-2290,-1865,18.0,1451.4
4523264320,0,78,1,1,4,10,7,0,0,0,0,15035,6.4,16650,183,60,-3584,-3248,18.3,1503.5,13,2,0,10,4,10,1,1,0,0,18619,7.6,19898,238,59,3584,3248,23.8,1861.9
4513950311,1,15,0,0,6,5,6,1,0,1,0,16107,7.0,17538,213,56,-456,-1135,21.3,1610.7,14,1,1,5,6,5,1,1,0,0,16563,7.0,18673,203,56,456,1135,20.3,1656.3
4518273376,1,14,2,0,12,3,11,2,1,1,0,19082,7.2,18970,226,52,4305,2244,22.6,1908.2,38,1,1,3,12,2,0,0,0,0,14777,6.6,16726,216,44,-4305,-2244,21.6,1477.7
4521172111,1,39,3,1,6,2,3,1,1,0,0,16569,7.2,19120,238,44,1398,1804,23.8,1656.9,17,18,0,2,6,3,0,0,0,0,15171,6.6,17316,233,60,-1398,-1804,23.3,1517.1
4510943404,1,23,1,1,7,6,9,0,0,0,0,16531,7.0,17534,218,40,-136,-290,21.8,1653.1,22,3,0,6,7,8,2,1,1,0,16667,7.0,17824,243,55,136,290,24.3,1666.7
4524450625,1,13,2,1,9,5,6,0,0,0,1,17795,7.0,18241,220,36,1642,878,22.0,1779.5,15,3,0,5,9,5,1,1,0,0,16153,6.8,17363,216,61,-1642,-878,21.6,1615.3
4527350448,1,20,2,1,8,10,5,1,1,0,0,16285,6.4,16278,183,48,-1655,-1008,18.3,1628.5,16,3,0,10,8,9,0,0,0,0,17940,6.6,17286,189,36,1655,1008,18.9,1794.0
4511256473,1,17,0,0,8,7,9,0,0,0,0,18593,7.4,20037,252,66,2277,1630,25.2,1859.3,13,1,1,7,8,9,1,1,0,0,16316,7.2,18407,203,56,-2277,-1630,20.3,1631.6
4477707123,1,18,4,1,7,5,6,1,1,0,0,16099,7.0,18219,203,48,873,678,20.3,1609.9,15,4,0,5,7,2,0,0,0,0,15226,6.8,17541,208,44,-873,-678,20.8,1522.6
4500920231,1,17,5,0,6,5,9,1,0,1,0,17544,7.0,18604,230,73,1092,1401,23.0,1754.4,22,4,1,5,6,9,0,0,0,0,16452,6.8,17203,258,30,-1092,-1401,25.8,1645.2
4522456399,0,17,4,1,10,8,17,1,0,1,0,18432,7.0,17701,203,53,1517,-69,20.3,1843.2,13,2,0,8,10,16,1,1,0,0,16915,6.8,17770,193,52,-1517,69,19.3,1691.5
4518960621,1,15,2,0,6,8,9,0,0,0,0,17279,6.8,17886,233,36,220,-740,23.3,1727.9,14,1,1,8,6,10,1,1,0,0,17059,7.2,18626,211,56,-220,740,21.1,1705.9
4484792751,0,157,2,1,6,8,4,2,1,1,0,16385,6.6,17327,215,58,-219,-589,21.5,1638.5,14,1,0,8,6,15,0,0,0,0,16604,6.8,17916,199,48,219,589,19.9,1660.4
4459832099,1,18,1,1,9,3,6,2,1,1,0,19155,7.6,20750,251,88,4526,2759,25.1,1915.5,14,4,0,3,9,3,0,0,0,0,14629,7.0,17991,192,48,-4526,-2759,19.2,1462.9
4478623490,0,21,2,1,7,6,6,0,0,0,0,16760,6.8,17857,206,51,-1052,-1064,20.6,1676.0,17,4,0,6,7,6,1,1,0,0,17812,7.2,18921,231,68,1052,1064,23.1,1781.2
4524908921,1,14,1,1,7,10,4,0,0,0,0,16663,6.8,17192,214,55,-1514,-1142,21.4,1666.3,14,1,0,10,7,19,1,1,0,0,18177,7.0,18334,217,39,1514,1142,21.7,1817.7
4515708683,1,46,1,0,4,10,4,1,1,0,0,15593,6.8,16199,204,4,-3101,-2897,20.4,1559.3,13,1,1,10,4,8,0,0,0,0,18694,7.0,19096,223,48,3101,2897,22.3,1869.4
4496561150,0,15,3,0,1,6,1,0,0,0,0,13126,6.6,17066,173,55,-3823,-2613,17.3,1312.6,27,3,1,6,1,3,2,1,1,0,16949,7.2,19679,234,63,3823,2613,23.4,1694.9
4526169931,1,14,2,0,6,5,5,0,0,0,0,16146,6.8,17725,210,52,1136,376,21.0,1614.6,13,3,1,5,6,0,1,1,0,0,15010,6.8,17349,198,58,-1136,-376,19.8,1501.0
4509682522,1,13,1,0,2,6,1,0,0,0,0,14804,7.0,17613,239,44,-1645,-1076,23.9,1480.4,28,1,1,6,2,7,1,1,0,0,16449,6.8,18689,245,47,1645,1076,24.5,1644.9
4480194384,0,15,2,1,5,7,4,0,0,0,0,15977,6.8,18136,206,71,-1130,-347,20.6,1597.7,15,2,0,7,5,8,1,1,0,0,17107,7.2,18483,230,56,1130,347,23.0,1710.7
4497727067,0,17,3,0,3,5,2,0,0,0,0,15195,7.0,17434,226,61,-713,-653,22.6,1519.5,17,3,1,5,3,6,1,1,0,0,15908,7.0,18087,232,54,713,653,23.2,1590.8
4467443224,1,18,3,0,6,12,6,0,0,0,0,16260,6.8,16989,211,42,-1791,-1671,21.1,1626.0,13,1,1,12,6,13,0,0,0,0,18051,7.0,18660,192,49,1791,1671,19.2,1805.1
4524881120,0,15,1,0,4,5,3,1,1,0,0,15158,7.0,17680,219,52,-1529,-1177,21.9,1515.8,52,1,1,5,4,7,0,0,0,0,16687,7.2,18857,213,59,1529,1177,21.3,1668.7
4431218839,1,13,3,1,6,4,6,1,1,0,0,17089,7.2,18072,232,52,2387,1690,23.2,1708.9,33,1,0,4,6,3,0,0,0,0,14702,6.6,16382,191,44,-2387,-1690,19.1,1470.2
4525956484,0,12,2,1,5,5,8,0,0,0,0,15930,6.4,15779,210,56,-95,-1474,21.0,1593.0,18,1,0,5,5,9,1,1,0,0,16025,6.8,17253,195,52,95,1474,19.5,1602.5
4527332360,1,56,4,0,2,5,3,0,0,0,0,14732,6.8,17531,210,52,-1461,-799,21.0,1473.2,13,10,1,5,2,6,1,1,0,0,16193,7.2,18330,240,55,1461,799,24.0,1619.3
4519130933,1,19,2,0,9,5,10,1,1,0,0,17967,7.0,18521,209,52,3066,2798,20.9,1796.7,15,4,1,5,9,4,0,0,0,0,14901,6.4,15723,177,31,-3066,-2798,17.7,1490.1
4456415287,1,17,2,1,13,5,9,0,0,0,0,19124,7.2,20438,244,56,3579,2679,24.4,1912.4,15,3,0,5,13,4,1,1,0,0,15545,7.0,17759,191,52,-3579,-2679,19.1,1554.5
4520794525,0,44,4,0,6,8,7,0,0,0,0,16295,6.8,17588,222,47,-1271,-364,22.2,1629.5,11,4,1,8,6,10,1,1,0,0,17566,6.8,17952,219,47,1271,364,21.9,1756.6
4521511498,1,15,0,0,5,7,4,1,1,0,0,15681,6.6,16896,205,50,-1058,-1404,20.5,1568.1,15,2,1,7,5,10,0,0,0,0,16739,7.0,18300,224,49,1058,1404,22.4,1673.9
4511593517,1,22,4,0,8,6,7,1,1,0,0,18070,7.2,19549,237,53,1263,590,23.7,1807.0,50,1,1,6,8,9,0,0,0,0,16807,7.4,18959,205,72,-1263,-590,20.5,1680.7
4454960221,0,46,3,0,5,12,4,0,0,0,0,16141,7.2,19127,215,52,-3324,-1649,21.5,1614.1,18,2,1,12,5,8,1,1,0,0,19465,7.6,20776,236,58,3324,1649,23.6,1946.5
4521789361,1,19,1,1,11,1,11,0,0,0,0,18622,7.2,19365,245,50,5269,3577,24.5,1862.2,36,1,0,1,11,1,0,0,0,0,13353,6.6,15788,189,45,-5269,-3577,18.9,1335.3
4419234240,1,13,5,1,9,2,13,1,1,0,0,19079,7.4,20020,249,59,4371,2705,24.9,1907.9,21,1,0,2,9,2,0,0,0,0,14708,6.8,17315,237,39,-4371,-2705,23.7,1470.8
4452601584,0,13,27,0,9,7,7,0,0,0,0,18012,7.0,19569,239,41,1194,2051,23.9,1801.2,45,4,1,7,9,6,1,1,0,0,16818,6.6,17518,221,42,-1194,-2051,22.1,1681.8
4491389277,1,11,1,0,7,6,5,0,0,0,0,17242,7.2,19085,236,53,403,1790,23.6,1724.2,14,2,1,6,7,9,0,0,0,0,16839,6.8,17295,216,47,-403,-1790,21.6,1683.9
4496865743,0,16,3,0,3,15,3,0,0,0,0,14281,6.2,13851,183,28,-7666,-5484,18.3,1428.1,19,0,1,15,3,15,1,0,1,1,21947,7.2,19335,231,80,7666,5484,23.1,2194.7
4520775356,1,14,3,1,11,2,8,2,1,1,0,19354,7.2,20036,251,48,5462,3677,25.1,1935.4,15,0,0,2,11,2,0,0,0,0,13892,6.8,16359,192,51,-5462,-3677,19.2,1389.2
4523979585,0,13,3,0,3,3,3,0,0,0,0,15006,7.0,18694,230,51,-1271,-366,23.0,1500.6,37,3,1,3,3,3,0,0,0,0,16277,7.2,19060,264,52,1271,366,26.4,1627.7
4521611632,1,10,1,1,7,6,11,2,1,1,0,17410,7.2,18496,239,62,1590,971,23.9,1741.0,12,0,0,6,7,8,0,0,0,0,15820,7.0,17525,216,46,-1590,-971,21.6,1582.0
4521458621,0,105,2,0,3,8,2,0,0,0,0,14533,6.8,17818,198,56,-4033,-1850,19.8,1453.3,14,2,1,8,3,9,1,1,0,0,18566,7.2,19668,220,64,4033,1850,22.0,1856.6
4520723011,1,35,2,1,5,0,4,1,1,0,0,17434,7.2,18954,257,54,4612,3848,25.7,1743.4,11,1,0,0,5,0,0,0,0,0,12822,6.4,15106,203,44,-4612,-3848,20.3,1282.2
4525122306,1,21,1,0,5,10,4,0,0,0,0,15363,6.4,16498,206,45,-2623,-2312,20.6,1536.3,14,4,1,10,5,16,1,0,1,0,17986,7.0,18810,226,33,2623,2312,22.6,1798.6
4521709624,1,41,3,1,7,7,5,1,1,0,0,16875,6.8,18112,219,48,-795,236,21.9,1687.5,19,3,0,7,7,9,0,0,0,0,17670,6.8,17876,221,44,795,-236,22.1,1767.0
4519708625,0,14,3,1,7,5,9,0,0,0,0,16655,7.2,18948,208,50,791,1064,20.8,1665.5,34,1,0,5,7,6,2,1,1,0,15864,6.8,17884,212,58,-791,-1064,21.2,1586.4
4524863981,0,19,2,0,4,11,3,0,0,0,0,15107,6.6,16753,200,41,-3799,-3285,20.0,1510.7,10,4,1,11,4,10,1,1,0,0,18906,7.2,20038,226,45,3799,3285,22.6,1890.6
4500435110,1,132,0,0,13,5,8,0,0,0,3,22845,7.4,19608,250,51,8234,6026,25.0,2284.5,24,2,1,5,13,5,0,0,0,0,14611,6.0,13582,158,40,-8234,-6026,15.8,1461.1
4518235291,0,14,3,0,6,6,7,1,1,0,0,15814,6.8,17161,205,49,-1530,-922,20.5,1581.4,20,2,1,6,6,6,1,0,1,0,17344,7.0,18083,252,48,1530,922,25.2,1734.4
4480198184,0,18,1,0,6,10,9,0,0,0,0,16853,7.0,18059,225,44,-1590,-1867,22.5,1685.3,12,2,1,10,6,9,1,1,0,0,18443,7.2,19926,242,55,1590,1867,24.2,1844.3
4496972532,0,16,2,1,5,8,6,0,0,0,0,15985,7.0,18011,214,52,-12,-1161,21.4,1598.5,12,2,0,8,5,4,0,0,0,0,15997,7.2,19172,194,45,12,1161,19.4,1599.7
4511992629,1,15,5,1,3,3,6,1,0,1,0,15204,6.8,17963,209,68,153,917,20.9,1520.4,13,4,0,3,3,3,1,1,0,0,15051,6.8,17046,232,51,-153,-917,23.2,1505.1
4480568476,0,17,2,1,5,9,6,0,0,0,0,14923,6.8,17285,173,37,-3916,-2883,17.3,1492.3,14,0,0,9,5,8,1,1,0,0,18839,7.4,20168,239,68,3916,2883,23.9,1883.9
4507582515,1,48,7,1,3,4,3,0,0,0,0,14482,6.8,17114,198,34,-3335,-2502,19.8,1448.2,18,6,0,4,3,4,2,1,1,1,17817,7.2,19616,248,52,3335,2502,24.8,1781.7
4503029657,1,18,4,0,10,9,10,0,0,0,0,18209,6.8,16955,200,37,1287,440,20.0,1820.9,11,1,1,9,10,16,0,0,0,0,16922,6.2,16515,198,53,-1287,-440,19.8,1692.2
4434527560,1,17,3,0,9,9,7,1,1,0,0,17442,7.0,18411,219,33,557,1853,21.9,1744.2,16,1,1,9,9,8,0,0,0,0,16885,6.6,16558,190,42,-557,-1853,19.0,1688.5
4468761566,0,15,1,1,4,8,6,0,0,0,0,14808,6.6,16376,180,42,-3363,-1920,18.0,1480.8,12,4,0,8,4,7,0,0,0,0,18171,7.0,18296,212,49,3363,1920,21.2,1817.1
4472468602,0,18,4,1,5,3,10,0,0,0,0,15496,6.6,16654,184,47,-157,-269,18.4,1549.6,17,3,0,3,5,4,1,1,0,0,15653,6.6,16923,229,55,157,269,22.9,1565.3
4518182783,0,16,1,0,5,6,6,1,0,1,0,14853,6.4,16170,174,48,-2673,-1867,17.4,1485.3,56,5,1,6,5,8,1,1,0,0,17526,7.0,18037,246,56,2673,1867,24.6,1752.6
4437780946,0,17,5,0,6,6,2,0,0,0,0,15196,6.8,18612,209,52,-1240,-76,20.9,1519.6,13,2,1,6,6,6,1,1,0,0,16436,7.0,18688,210,68,1240,76,21.0,1643.6
4431359943,0,17,2,0,6,10,7,1,1,0,0,15336,6.6,16676,187,56,-2735,-2136,18.7,1533.6,15,1,1,10,6,9,1,0,1,0,18071,7.0,18812,226,46,2735,2136,22.6,1807.1
4522051549,0,16,3,1,8,11,8,0,0,0,0,17739,6.6,16482,215,55,377,-597,21.5,1773.9,22,4,0,11,8,12,2,1,1,0,17362,6.8,17079,197,44,-377,597,19.7,1736.2
4523421831,0,11,4,1,4,4,7,1,1,0,0,15788,6.8,18264,243,50,671,881,24.3,1578.8,17,0,0,4,4,5,0,0,0,0,15117,7.0,17383,228,48,-671,-881,22.8,1511.7
4505820252,1,14,1,0,2,3,2,2,1,1,0,16394,7.4,20016,264,85,1447,1753,26.4,1639.4,13,3,1,3,2,1,0,0,0,0,14947,6.8,18263,227,54,-1447,-1753,22.7,1494.7
4501319055,1,21,4,0,6,2,6,1,1,0,0,16844,7.0,18805,243,45,2726,1990,24.3,1684.4,39,4,1,2,6,1,0,0,0,0,14118,6.8,16815,210,50,-2726,-1990,21.0,1411.8
4493176020,0,16,2,1,3,8,2,0,0,0,0,14566,7.0,16999,190,45,-2414,-959,19.0,1456.6,17,4,0,8,3,12,0,0,0,0,16980,6.8,17958,218,45,2414,959,21.8,1698.0
4524775955,1,14,2,0,6,9,7,2,1,1,0,15649,6.8,17052,186,44,-2822,-1240,18.6,1564.9,13,2,1,9,6,9,0,0,0,0,18471,7.0,18292,248,32,2822,1240,24.8,1847.1
4524367614,1,13,0,1,5,10,6,0,0,0,0,15366,6.8,16496,200,40,-2698,-2969,20.0,1536.6,17,0,0,10,5,8,2,1,1,0,18064,7.2,19465,221,52,2698,2969,22.1,1806.4
4500087956,0,20,3,1,6,3,6,0,0,0,0,16993,7.4,19908,230,60,1886,1688,23.0,1699.3,15,5,0,3,6,4,0,0,0,0,15107,7.0,18220,230,48,-1886,-1688,23.0,1510.7
4442492836,1,38,5,1,5,4,5,1,1,0,0,15967,6.8,17855,203,62,803,798,20.3,1596.7,18,1,0,4,5,6,0,0,0,0,15164,6.8,17057,226,38,-803,-798,22.6,1516.4
4515573007,0,18,3,0,4,7,6,0,0,0,0,16112,7.2,18339,247,46,-692,-758,24.7,1611.2,38,2,1,7,4,7,2,1,1,0,16804,7.2,19097,223,50,692,758,22.3,1680.4
4525832836,0,17,4,1,5,4,3,1,1,0,0,15926,6.6,16415,247,48,-299,-1889,24.7,1592.6,36,2,0,4,5,4,0,0,0,0,16225,7.0,18304,230,49,299,1889,23.0,1622.5
4499276253,0,13,2,0,1,2,2,0,0,0,0,12884,6.4,15586,174,40,-2825,-3105,17.4,1288.4,16,2,1,2,1,4,1,1,0,0,15709,7.0,18691,239,63,2825,3105,23.9,1570.9
4522023642,0,13,1,0,4,12,4,0,0,0,0,13973,6.2,15260,166,45,-6801,-4611,16.6,1397.3,77,4,1,12,4,14,1,0,1,1,20774,7.4,19871,234,44,6801,4611,23.4,2077.4
4458587612,0,13,2,0,2,9,1,0,0,0,0,14442,6.6,16650,202,48,-4719,-2129,20.2,1444.2,18,1,1,9,2,10,1,1,0,1,19161,7.0,18779,225,48,4719,2129,22.5,1916.1
4516373262,0,14,2,1,4,3,5,0,0,0,0,15945,7.2,18619,204,51,405,487,20.4,1594.5,15,1,0,3,4,2,0,0,0,0,15540,7.0,18132,236,55,-405,-487,23.6,1554.0
4527767522,1,18,4,0,6,2,8,1,1,0,0,16055,7.0,18838,208,64,583,439,20.8,1605.5,38,5,1,2,6,1,0,0,0,0,15472,7.2,18399,259,54,-583,-439,25.9,1547.2
4524840446,0,13,0,0,5,10,7,0,0,0,0,13742,5.6,12556,123,18,-5705,-5364,12.3,1374.2,13,1,1,10,5,11,1,1,0,0,19447,6.8,17920,218,40,5705,5364,21.8,1944.7
4509908881,1,14,2,1,14,3,19,1,1,0,1,22472,7.6,20870,251,54,8284,4654,25.1,2247.2,15,2,0,3,14,5,0,0,0,0,14188,6.6,16216,202,34,-8284,-4654,20.2,1418.8
4500179611,1,16,3,0,1,2,2,0,0,0,0,13772,6.6,16974,231,48,-845,-571,23.1,1377.2,22,3,1,2,1,4,1,1,0,0,14617,7.0,17545,197,60,845,571,19.7,1461.7
4513777315,0,17,3,1,10,7,11,1,1,0,0,18454,7.2,19370,230,53,1455,602,23.0,1845.4,19,4,0,7,10,5,0,0,0,0,16999,7.0,18768,247,48,-1455,-602,24.7,1699.9
4464521946,0,17,4,1,4,8,3,1,1,0,0,15769,6.8,17360,222,59,-2999,-1476,22.2,1576.9,18,3,0,8,4,11,0,0,0,1,18768,7.0,18836,232,60,2999,1476,23.2,1876.8
4458488872,1,15,0,1,8,6,11,1,1,0,0,16091,6.8,16748,200,44,-765,-492,20.0,1609.1,35,2,0,6,8,11,0,0,0,0,16856,7.0,17240,185,44,765,492,18.5,1685.6
4501834987,1,18,4,1,5,4,5,1,1,0,0,16688,7.2,18714,226,60,859,128,22.6,1668.8,14,3,0,4,5,5,0,0,0,0,15829,7.0,18586,242,36,-859,-128,24.2,1582.9
4484002514,1,18,4,1,4,1,3,2,1,1,0,16231,7.2,18511,271,52,693,-204,27.1,1623.1,15,4,0,1,4,1,0,0,0,0,15538,7.2,18715,245,59,-693,204,24.5,1553.8
4519728493,1,18,2,1,10,4,13,1,0,1,0,17902,7.2,18882,186,50,2224,2062,18.6,1790.2,15,2,0,4,10,7,1,1,0,0,15678,6.6,16820,208,44,-2224,-2062,20.8,1567.8
4480357961,0,19,5,0,4,5,5,1,0,1,0,16318,6.6,17365,218,48,-326,315,21.8,1631.8,19,1,1,5,4,9,1,1,0,0,16644,6.8,17050,209,51,326,-315,20.9,1664.4
4524687163,0,18,6,1,8,3,14,1,1,0,0,18022,7.0,18610,242,56,2958,983,24.2,1802.2,18,0,0,3,8,2,0,0,0,0,15064,7.0,17627,226,44,-2958,-983,22.6,1506.4
4447986050,1,20,6,1,11,8,12,1,1,0,0,19349,7.2,19673,219,51,2445,1807,21.9,1934.9,15,2,0,8,11,10,0,0,0,0,16904,6.8,17866,194,48,-2445,-1807,19.4,1690.4
4461353444,0,60,4,1,7,3,9,1,1,0,0,16938,7.0,18699,226,56,1516,426,22.6,1693.8,16,6,0,3,7,4,0,0,0,0,15422,7.0,18273,210,60,-1516,-426,21.0,1542.2
4497452633,1,17,4,0,9,5,7,0,0,0,0,17959,7.6,20494,239,56,1696,2266,23.9,1795.9,19,5,1,5,9,3,1,1,0,0,16263,6.8,18228,225,56,-1696,-2266,22.5,1626.3
4477069725,1,16,3,0,5,6,7,1,1,0,0,16539,7.4,19570,242,62,-65,1208,24.2,1653.9,19,6,1,6,5,7,0,0,0,0,16604,7.0,18362,230,43,65,-1208,23.0,1660.4
4522772001,0,14,2,0,4,6,1,0,0,0,0,15310,7.0,18337,221,52,-1038,-1307,22.1,1531.0,15,2,1,6,4,5,2,1,1,0,16348,7.2,19644,226,66,1038,1307,22.6,1634.8
4491275026,0,17,2,0,2,3,2,1,0,1,0,14355,6.8,17580,217,51,59,1149,21.7,1435.5,17,3,1,3,2,6,1,1,0,0,14296,6.6,16431,205,39,-59,-1149,20.5,1429.6
4419869178,1,16,2,1,6,7,3,1,0,1,0,15907,7.2,17910,206,55,-112,727,20.6,1590.7,17,3,0,7,6,9,0,0,0,0,16019,6.8,17183,211,44,112,-727,21.1,1601.9
4450382504,1,36,3,1,9,2,13,0,0,0,0,19570,7.8,21203,259,74,4826,4472,25.9,1957.0,17,3,0,2,9,4,1,1,0,0,14744,6.6,16731,229,52,-4826,-4472,22.9,1474.4
4494851448,0,18,5,1,4,3,5,1,1,0,0,15449,6.8,17026,206,52,423,-315,20.6,1544.9,18,3,0,3,4,1,0,0,0,0,15026,6.6,17341,254,44,-423,315,25.4,1502.6
4463166329,1,16,2,1,7,7,7,2,1,1,0,16559,7.2,18848,235,43,-167,39,23.5,1655.9,13,3,0,7,7,5,0,0,0,0,16726,7.0,18809,237,48,167,-39,23.7,1672.6
4524260253,1,15,1,0,10,4,8,1,0,1,2,20352,7.4,19537,232,57,5649,3668,23.2,2035.2,14,2,1,4,10,6,1,1,0,0,14703,6.4,15869,200,38,-5649,-3668,20.0,1470.3
4490677497,0,13,4,0,7,13,3,1,1,0,0,17090,7.0,18662,222,72,-2001,-1137,22.2,1709.0,19,1,1,13,7,20,0,0,0,0,19091,7.6,19799,217,24,2001,1137,21.7,1909.1
4464639816,0,48,3,0,3,7,0,0,0,0,0,14467,7.0,17728,220,58,-2287,-735,22.0,1446.7,16,3,1,7,3,6,1,1,0,0,16754,7.0,18463,218,40,2287,735,21.8,1675.4
4492509344,1,18,3,0,4,3,3,1,1,0,0,15442,7.2,18590,220,64,-79,-815,22.0,1544.2,51,3,1,3,4,4,1,0,1,0,15521,7.2,19405,217,72,79,815,21.7,1552.1
4509027219,1,23,2,1,3,1,3,0,0,0,0,16468,6.8,18574,249,54,3100,1653,24.9,1646.8,19,2,0,1,3,0,0,0,0,0,13368,6.6,16921,192,41,-3100,-1653,19.2,1336.8
4500568578,0,15,4,0,1,4,2,1,1,0,0,13925,7.0,18363,216,60,-3617,-1967,21.6,1392.5,78,1,1,4,1,5,0,0,0,0,17542,7.4,20330,260,80,3617,1967,26.0,1754.2
4519247405,1,16,3,0,3,5,4,1,1,0,0,15501,7.0,17414,245,40,-257,-180,24.5,1550.1,55,2,1,5,3,7,0,0,0,0,15758,6.8,17594,199,52,257,180,19.9,1575.8
4486082210,0,14,2,1,5,9,6,2,1,1,0,16142,6.8,16958,230,51,-1231,-888,23.0,1614.2,25,2,0,9,5,11,0,0,0,0,17373,6.8,17846,221,53,1231,888,22.1,1737.3
4516933345,1,17,2,0,9,7,8,1,1,0,0,17661,6.6,17077,233,40,815,590,23.3,1766.1,17,3,1,7,9,10,0,0,0,0,16846,6.8,16487,191,38,-815,-590,19.1,1684.6
4499984272,0,21,3,0,4,8,7,0,0,0,0,14655,6.6,16541,208,37,-3142,-2633,20.8,1465.5,20,3,1,8,4,17,1,0,1,0,17797,7.2,19174,216,56,3142,2633,21.6,1779.7
4517859191,0,17,3,0,3,11,3,0,0,0,0,14595,6.4,15064,161,59,-3619,-4011,16.1,1459.5,47,2,1,11,3,9,1,1,0,0,18214,7.2,19075,222,54,3619,4011,22.2,1821.4
4462515361,1,16,1,0,7,5,7,1,1,0,0,16346,6.8,17401,227,52,-90,102,22.7,1634.6,14,2,1,5,7,5,0,0,0,0,16436,7.0,17299,234,40,90,-102,23.4,1643.6
4464812857,1,11,4,0,8,4,9,1,1,0,0,17397,7.2,19011,244,52,2598,4512,24.4,1739.7,23,0,1,4,8,7,0,0,0,0,14799,5.8,14499,186,49,-2598,-4512,18.6,1479.9
4523621040,1,12,4,0,4,4,2,1,1,0,0,15488,7.2,18538,240,51,-344,1361,24.0,1548.8,16,1,1,4,4,4,0,0,0,0,15832,6.6,17177,241,48,344,-1361,24.1,1583.2
4484374414,0,17,4,1,3,11,3,0,0,0,0,14953,6.6,17005,221,57,-3903,-2090,22.1,1495.3,15,4,0,11,3,18,1,1,0,0,18856,7.2,19095,239,47,3903,2090,23.9,1885.6
4524848216,0,35,3,0,6,8,4,0,0,0,0,15589,6.6,16619,181,40,-1535,-2054,18.1,1558.9,38,1,1,8,6,10,1,0,1,0,17124,7.0,18673,210,56,1535,2054,21.0,1712.4
4501534072,0,51,5,0,6,5,7,0,0,0,0,15913,7.0,17268,195,68,-125,-637,19.5,1591.3,22,3,1,5,6,7,1,1,0,0,16038,6.8,17905,232,48,125,637,23.2,1603.8
4518877029,0,16,3,1,5,4,3,1,1,0,0,16374,7.2,18711,227,55,412,93,22.7,1637.4,31,5,0,4,5,1,0,0,0,0,15962,7.2,18618,234,64,-412,-93,23.4,1596.2
4494937598,0,13,2,0,6,7,8,0,0,0,0,16068,7.2,18240,209,54,-932,-517,20.9,1606.8,15,1,1,7,6,4,2,1,1,0,17000,7.2,18757,240,44,932,517,24.0,1700.0
4486077838,0,16,5,1,4,8,7,0,0,0,0,15557,6.6,17145,212,50,-2101,-2009,21.2,1555.7,18,3,0,8,4,11,2,1,1,0,17658,7.2,19154,249,50,2101,2009,24.9,1765.8
4493317372,1,12,1,1,5,4,5,1,1,0,0,15807,7.0,18131,219,59,70,409,21.9,1580.7,14,1,0,4,5,8,0,0,0,0,15737,7.0,17722,221,60,-70,-409,22.1,1573.7
4523346192,0,13,1,0,5,7,5,1,0,1,0,15814,6.8,17936,229,39,-1706,-685,22.9,1581.4,13,3,1,7,5,10,1,1,0,0,17520,7.0,18621,238,68,1706,685,23.8,1752.0
4487268052,0,45,5,0,4,3,5,1,1,0,0,15398,7.2,17861,200,54,378,321,20.0,1539.8,55,6,1,3,4,2,1,0,1,0,15020,7.0,17540,227,48,-378,-321,22.7,1502.0
4525772082,0,19,6,0,2,8,2,1,0,1,0,14970,6.8,17809,235,59,-2366,-340,23.5,1497.0,21,4,1,8,2,14,0,0,0,0,17336,6.8,18149,226,34,2366,340,22.6,1733.6
4494500781,1,18,5,0,6,9,7,2,1,1,0,18050,7.2,18264,238,60,284,681,23.8,1805.0,58,5,1,9,6,15,0,0,0,0,17766,6.8,17583,207,52,-284,-681,20.7,1776.6
4527487988,0,64,2,1,6,7,9,0,0,0,0,16054,6.6,17023,202,52,-849,-603,20.2,1605.4,15,4,0,7,6,7,1,1,0,0,16903,6.8,17626,215,46,849,603,21.5,1690.3
4495141032,0,38,3,1,7,2,11,0,0,0,0,17371,6.6,17488,209,47,3058,1096,20.9,1737.1,15,4,0,2,7,2,0,0,0,0,14313,6.6,16392,230,35,-3058,-1096,23.0,1431.3
4463080911,0,17,4,0,6,7,7,0,0,0,0,17132,7.2,19401,237,71,789,1620,23.7,1713.2,14,3,1,7,6,6,0,0,0,0,16343,7.0,17781,209,32,-789,-1620,20.9,1634.3
4497616954,1,12,5,0,5,2,3,1,1,0,0,16226,7.0,18917,250,56,2229,2851,25.0,1622.6,15,3,1,2,5,2,0,0,0,0,13997,6.4,16066,197,40,-2229,-2851,19.7,1399.7
4521611697,1,34,3,1,9,8,6,0,0,0,0,17532,7.2,18592,233,44,1068,1295,23.3,1753.2,14,4,0,8,9,10,0,0,0,0,16464,6.8,17297,200,39,-1068,-1295,20.0,1646.4
4511656001,1,16,2,1,8,3,5,2,1,1,1,18661,7.4,19718,233,56,4867,4211,23.3,1866.1,14,1,0,3,8,7,0,0,0,0,13794,6.6,15507,169,40,-4867,-4211,16.9,1379.4
4522814409,0,14,2,0,3,12,2,0,0,0,0,14769,6.4,16504,205,45,-4374,-2570,20.5,1476.9,14,3,1,12,3,13,0,0,0,0,19143,7.0,19074,209,53,4374,2570,20.9,1914.3
4441621695,1,13,1,0,6,7,7,1,1,0,0,16564,7.0,17725,222,48,-850,-256,22.2,1656.4,18,2,1,7,6,7,1,0,1,0,17414,7.0,17981,201,56,850,256,20.1,1741.4
4520399524,1,15,0,0,2,4,3,0,0,0,0,14808,6.8,16826,219,50,-1352,-2339,21.9,1480.8,14,3,1,4,2,5,0,0,0,0,16160,7.4,19165,257,51,1352,2339,25.7,1616.0
4520923371,0,38,3,1,3,3,6,1,1,0,0,16653,7.0,18507,261,60,1152,-29,26.1,1665.3,15,2,0,3,3,6,0,0,0,0,15501,7.2,18536,228,60,-1152,29,22.8,1550.1
4527157118,1,14,2,0,12,5,10,1,1,0,0,19296,7.4,18995,222,56,3611,2136,22.2,1929.6,15,1,1,5,12,7,0,0,0,0,15685,6.8,16859,180,46,-3611,-2136,18.0,1568.5
4523841785,1,20,4,1,12,6,9,1,1,0,0,18259,7.2,19685,218,48,2254,1555,21.8,1825.9,17,4,0,6,12,3,0,0,0,0,16005,7.0,18130,215,42,-2254,-1555,21.5,1600.5
4515343206,1,17,3,1,12,11,10,0,0,0,0,18882,7.2,19357,224,56,291,839,22.4,1888.2,20,3,0,11,12,13,0,0,0,0,18591,6.8,18518,222,38,-291,-839,22.2,1859.1
4468293476,1,25,1,1,3,3,4,0,0,0,0,15834,7.0,18253,248,52,324,-574,24.8,1583.4,9,2,0,3,3,3,2,1,1,0,15510,7.2,18827,220,68,-324,574,22.0,1551.0
4468603101,1,17,4,0,9,4,6,1,0,1,1,19663,7.2,19052,247,48,4043,1803,24.7,1966.3,15,0,1,4,9,5,0,0,0,0,15620,6.8,17249,214,51,-4043,-1803,21.4,1562.0
4518060637,1,14,2,0,9,5,13,0,0,0,0,17099,7.2,19592,225,48,1344,2079,22.5,1709.9,16,1,1,5,9,2,1,1,0,0,15755,6.8,17513,238,48,-1344,-2079,23.8,1575.5
4452162573,0,20,3,1,4,4,6,0,0,0,0,15474,6.6,16611,231,28,331,-1585,23.1,1547.4,15,2,0,4,4,5,1,1,0,0,15143,7.2,18196,216,51,-331,1585,21.6,1514.3
4489343970,0,15,1,0,3,5,2,0,0,0,0,16102,7.2,19258,257,66,-281,110,25.7,1610.2,13,3,1,5,3,4,1,1,0,0,16383,7.0,19148,251,50,281,-110,25.1,1638.3
4461960551,1,55,1,1,4,2,5,0,0,0,0,16161,6.8,17916,230,60,901,-1138,23.0,1616.1,14,0,0,2,4,3,1,1,0,0,15260,7.0,19054,246,60,-901,1138,24.6,1526.0
4513340432,0,13,4,1,11,6,17,1,1,0,1,19900,7.0,17323,200,41,4027,701,20.0,1990.0,19,3,0,6,11,9,0,0,0,0,15873,6.6,16622,197,58,-4027,-701,19.7,1587.3
4514522984,1,14,3,0,0,5,0,0,0,0,0,12939,6.4,15958,201,32,-4578,-3673,20.1,1293.9,19,2,1,5,0,5,1,1,0,0,17517,7.4,19631,259,79,4578,3673,25.9,1751.7
4525247260,1,18,9,1,9,1,13,1,1,0,0,17461,7.2,18412,235,48,3119,896,23.5,1746.1,44,2,0,1,9,1,1,0,1,0,14342,7.0,17516,228,56,-3119,-896,22.8,1434.2
4426644547,1,14,4,1,7,7,6,0,0,0,1,19229,7.2,18820,257,62,3545,2162,25.7,1922.9,19,3,0,7,7,10,1,1,0,0,15684,6.6,16658,145,36,-3545,-2162,14.5,1568.4
4504128321,1,15,3,1,10,6,9,0,0,0,0,18288,7.2,19569,245,41,2569,1891,24.5,1828.8,127,4,0,6,10,4,1,0,1,0,15719,6.8,17678,220,41,-2569,-1891,22.0,1571.9
4488507163,0,17,2,0,7,11,13,1,1,0,0,16225,6.6,17213,206,56,-2463,-2163,20.6,1622.5,17,3,1,11,7,13,0,0,0,0,18688,7.4,19376,224,36,2463,2163,22.4,1868.8
4494726186,1,11,4,0,4,6,3,0,0,0,0,15727,7.2,18903,247,44,-84,221,24.7,1572.7,14,1,1,6,4,4,0,0,0,0,15811,7.2,18682,216,52,84,-221,21.6,1581.1
4527477768,1,12,2,0,11,8,13,0,0,0,0,18420,7.0,19041,218,42,1472,1838,21.8,1842.0,18,2,1,8,11,9,0,0,0,0,16948,6.8,17203,209,41,-1472,-1838,20.9,1694.8
4511067613,0,15,6,0,8,7,9,1,1,0,0,17163,7.2,18565,221,60,515,1691,22.1,1716.3,15,1,1,7,8,14,0,0,0,0,16648,6.6,16874,211,43,-515,-1691,21.1,1664.8
4500913253,1,34,2,1,10,10,12,0,0,0,0,18152,7.0,18364,196,56,-973,-2396,19.6,1815.2,15,2,0,10,10,10,0,0,0,0,19125,7.4,20760,238,68,973,2396,23.8,1912.5
4524960112,0,12,12,1,4,8,6,0,0,0,0,15263,6.8,16941,203,50,-2548,-2906,20.3,1526.3,33,5,0,8,4,14,1,1,0,0,17811,7.2,19847,232,62,2548,2906,23.2,1781.1
4515396713,1,13,3,1,5,4,5,1,0,1,0,16582,6.8,18262,216,66,380,-239,21.6,1658.2,58,4,0,4,5,6,1,1,0,0,16202,6.8,18501,246,41,-380,239,24.6,1620.2
4525551314,0,11,2,1,10,4,10,0,0,0,1,19095,7.2,19444,219,44,2999,2184,21.9,1909.5,12,1,0,4,10,2,0,0,0,0,16096,6.6,17260,204,48,-2999,-2184,20.4,1609.6
4467242137,0,15,2,1,3,4,6,0,0,0,0,14782,6.8,16677,213,49,-1464,-1509,21.3,1478.2,19,1,0,4,3,4,1,1,0,0,16246,7.0,18186,238,56,1464,1509,23.8,1624.6
4527366202,1,39,1,0,1,10,1,1,0,1,0,14529,6.6,17127,218,56,-2930,-1894,21.8,1452.9,74,13,1,10,1,17,0,0,0,0,17459,7.2,19021,207,44,2930,1894,20.7,1745.9
4523305725,0,12,0,0,1,8,0,0,0,0,0,12791,6.6,16317,173,46,-4684,-3216,17.3,1279.1,13,1,1,8,1,3,1,1,0,0,17475,7.2,19533,239,44,4684,3216,23.9,1747.5
4494865668,0,19,4,1,4,3,1,1,0,1,0,15454,6.6,17213,226,49,957,406,22.6,1545.4,16,3,0,3,4,3,0,0,0,0,14497,6.8,16807,215,50,-957,-406,21.5,1449.7
4524954902,0,14,9,0,6,8,10,0,0,0,0,16172,6.8,18147,189,60,-1257,333,18.9,1617.2,19,4,1,8,6,11,1,1,0,0,17429,7.0,17814,226,36,1257,-333,22.6,1742.9
4524558517,0,29,0,0,5,6,6,0,0,0,0,15693,6.8,17777,210,51,-486,-137,21.0,1569.3,35,1,1,6,5,5,1,1,0,0,16179,7.0,17914,216,52,486,137,21.6,1617.9
4517001678,0,13,3,0,6,12,5,1,1,0,0,15716,6.8,17135,189,46,-3393,-1177,18.9,1571.6,14,3,1,12,6,19,0,0,0,0,19109,6.8,18312,206,44,3393,1177,20.6,1910.9
4526316157,0,11,2,0,4,13,3,0,0,0,0,14539,6.6,16271,165,53,-6139,-4548,16.5,1453.9,58,3,1,13,4,12,0,0,0,0,20678,7.6,20819,224,50,6139,4548,22.4,2067.8
4521155877,0,20,2,0,3,6,1,0,0,0,0,14719,6.6,16759,214,43,-2418,-2255,21.4,1471.9,38,1,1,6,3,7,0,0,0,0,17137,7.0,19014,240,64,2418,2255,24.0,1713.7
4521912721,0,14,7,0,1,2,2,0,0,0,0,15231,7.0,18127,262,52,-13,-378,26.2,1523.1,15,1,1,2,1,3,1,1,0,0,15244,7.0,18505,232,67,13,378,23.2,1524.4
4470582176,0,33,4,1,8,9,9,0,0,0,0,18026,7.0,17839,198,44,726,-455,19.8,1802.6,17,2,0,9,8,12,0,0,0,0,17300,7.0,18294,186,68,-726,455,18.6,1730.0
4502578758,1,21,2,1,7,4,12,0,0,0,0,17380,6.8,18705,232,50,2615,2028,23.2,1738.0,14,3,0,4,7,3,0,0,0,0,14765,6.6,16677,181,56,-2615,-2028,18.1,1476.5
4517778477,1,13,2,1,7,6,12,1,1,0,0,16679,7.0,17760,193,47,273,87,19.3,1667.9,12,3,0,6,7,9,0,0,0,0,16406,6.8,17673,215,48,-273,-87,21.5,1640.6
4522484818,0,16,2,1,8,8,8,0,0,0,0,17698,7.2,18605,218,56,-373,-1526,21.8,1769.8,14,2,0,8,8,5,1,1,0,0,18071,7.4,20131,233,76,373,1526,23.3,1807.1
4473464467,0,13,1,0,4,11,3,1,1,0,0,15225,6.2,16104,187,45,-5182,-3884,18.7,1522.5,13,1,1,11,4,9,1,0,1,2,20407,7.4,19988,246,53,5182,3884,24.6,2040.7
4472597794,0,16,1,0,7,7,4,1,1,0,0,16518,7.0,18036,229,43,176,943,22.9,1651.8,10,1,1,7,7,9,0,0,0,0,16342,6.6,17093,200,38,-176,-943,20.0,1634.2
4488919403,0,15,0,0,5,5,7,0,0,0,0,14469,6.2,15329,136,48,-2579,-3819,13.6,1446.9,14,3,1,5,5,2,1,0,1,0,17048,7.2,19148,244,60,2579,3819,24.4,1704.8
4527363053,1,37,2,1,7,4,6,2,1,1,0,17162,7.6,20178,249,44,3035,3792,24.9,1716.2,19,2,0,4,7,3,0,0,0,0,14127,6.6,16386,170,47,-3035,-3792,17.0,1412.7
4525312935,1,22,1,0,6,4,4,1,0,1,0,16926,7.2,19020,229,52,1947,1677,22.9,1692.6,17,3,1,4,6,1,1,1,0,0,14979,6.8,17343,230,44,-1947,-1677,23.0,1497.9
4486764809,0,16,4,0,1,3,1,1,0,1,0,14605,7.0,17830,244,48,-280,903,24.4,1460.5,14,3,1,3,1,3,1,1,0,0,14885,6.6,16927,217,60,280,-903,21.7,1488.5
4454573791,0,20,7,1,4,8,7,1,0,1,0,15228,6.8,16963,198,52,-2236,-2070,19.8,1522.8,20,5,0,8,4,8,1,1,0,0,17464,7.2,19033,227,48,2236,2070,22.7,1746.4
4462131057,1,17,5,1,16,5,25,1,1,0,0,20996,7.2,19123,218,47,6476,4261,21.8,2099.6,13,3,0,5,16,8,0,0,0,0,14520,6.2,14862,147,41,-6476,-4261,14.7,1452.0
4520016243,1,14,3,0,12,2,18,1,1,0,0,19273,7.2,18465,226,60,5784,4755,22.6,1927.3,11,1,1,2,12,2,0,0,0,0,13489,6.0,13710,168,52,-5784,-4755,16.8,1348.9
4526935015,1,15,6,1,6,3,5,1,1,0,0,16638,7.2,18824,212,67,1402,1512,21.2,1663.8,21,2,0,3,6,3,0,0,0,0,15236,6.8,17312,230,52,-1402,-1512,23.0,1523.6
4479934659,0,18,2,1,11,9,13,0,0,0,0,17794,7.2,18646,211,39,337,-260,21.1,1779.4,13,4,0,9,11,7,1,1,0,0,17457,7.0,18906,218,56,-337,260,21.8,1745.7
4521806939,1,17,3,1,10,5,11,1,1,0,0,17556,6.8,17943,206,40,2153,799,20.6,1755.6,16,2,0,5,10,7,0,0,0,0,15403,6.8,17144,202,51,-2153,-799,20.2,1540.3
4519085208,1,15,0,1,4,1,5,1,1,0,0,15942,7.2,19003,232,71,486,865,23.2,1594.2,20,4,0,1,4,2,0,0,0,0,15456,7.0,18138,242,64,-486,-865,24.2,1545.6
4508952905,0,15,3,0,3,4,2,0,0,0,0,14961,7.0,18313,230,52,33,817,23.0,1496.1,24,5,1,4,3,3,1,1,0,0,14928,7.0,17496,191,55,-33,-817,19.1,1492.8
4410060427,0,17,4,1,5,5,5,1,0,1,0,16574,7.2,19529,235,60,803,857,23.5,1657.4,18,4,0,5,5,6,1,1,0,0,15771,7.2,18672,204,64,-803,-857,20.4,1577.1
4522840009,0,18,1,0,6,3,8,0,0,0,0,17099,7.2,19019,222,69,1847,1663,22.2,1709.9,16,0,1,3,6,5,2,1,1,0,15252,6.8,17356,210,70,-1847,-1663,21.0,1525.2
4520582438,0,28,1,1,12,11,12,0,0,0,0,18336,7.0,17626,179,55,-466,-26,17.9,1833.6,15,2,0,11,12,19,0,0,0,0,18802,6.6,17652,211,32,466,26,21.1,1880.2
4514342696,1,19,1,0,9,7,11,1,1,0,0,17762,7.0,18599,233,32,849,794,23.3,1776.2,39,2,1,7,9,8,0,0,0,0,16913,6.8,17805,200,56,-849,-794,20.0,1691.3
4510548126,0,16,3,1,4,11,4,0,0,0,0,16314,6.8,16894,250,48,-2665,-900,25.0,1631.4,17,5,0,11,4,14,2,1,1,1,18979,7.0,17794,200,58,2665,900,20.0,1897.9
4525369835,0,41,2,0,2,7,4,1,1,0,0,15032,7.0,18462,232,68,-2785,-453,23.2,1503.2,22,3,1,7,2,7,1,0,1,0,17817,7.2,18915,228,55,2785,453,22.8,1781.7
4511941552,1,17,6,0,8,2,9,1,1,0,0,16699,7.0,18113,238,36,1718,1073,23.8,1669.9,16,3,1,2,8,3,0,0,0,0,14981,6.8,17040,225,56,-1718,-1073,22.5,1498.1
4524603410,1,15,1,1,8,7,6,1,1,0,0,17850,7.2,19943,238,71,1097,1914,23.8,1785.0,16,2,0,7,8,6,0,0,0,0,16753,7.0,18029,224,40,-1097,-1914,22.4,1675.3
4470465305,0,22,1,0,5,12,12,0,0,0,0,16220,7.0,17906,222,66,-4157,-1724,22.2,1622.0,15,1,1,12,5,24,1,1,0,0,20377,7.4,19630,257,52,4157,1724,25.7,2037.7
4522855501,1,20,6,1,13,4,7,1,1,0,1,20587,7.4,19713,229,48,5920,2703,22.9,2058.7,16,3,0,4,13,3,0,0,0,0,14667,6.8,17010,168,58,-5920,-2703,16.8,1466.7
4526734113,1,17,3,1,8,5,12,0,0,0,0,17469,7.0,18265,242,44,1625,121,24.2,1746.9,14,2,0,5,8,4,0,0,0,0,15844,6.8,18144,236,51,-1625,-121,23.6,1584.4
4522617067,0,39,1,0,7,14,5,0,0,0,0,16190,6.6,16496,207,34,-2302,-997,20.7,1619.0,17,5,1,14,7,16,0,0,0,0,18492,6.6,17493,173,52,2302,997,17.3,1849.2
4517803168,1,20,3,1,13,6,12,0,0,0,0,19012,7.2,18944,210,54,2194,1814,21.0,1901.2,19,2,0,6,13,9,0,0,0,0,16818,6.8,17130,195,49,-2194,-1814,19.5,1681.8
4470529446,0,11,0,0,4,7,4,0,0,0,0,16182,7.0,18355,216,46,-925,-360,21.6,1618.2,15,0,1,7,4,7,2,1,1,0,17107,7.0,18715,212,67,925,360,21.2,1710.7
4515249145,1,17,4,1,9,8,9,1,1,0,0,17375,6.8,18035,217,50,238,368,21.7,1737.5,21,4,0,8,9,11,0,0,0,0,17137,6.8,17667,207,40,-238,-368,20.7,1713.7
4525145899,0,33,1,0,1,9,0,0,0,0,0,13933,6.6,16583,194,51,-5490,-2476,19.4,1393.3,18,2,1,9,1,8,1,1,0,1,19423,7.2,19059,225,52,5490,2476,22.5,1942.3
4494262239,0,14,0,0,3,4,6,0,0,0,0,15929,6.8,17529,226,40,-394,-1635,22.6,1592.9,14,1,1,4,3,4,1,0,1,0,16323,7.0,19164,237,64,394,1635,23.7,1632.3
4483926766,1,15,4,0,5,10,5,1,0,1,0,14982,6.6,15862,171,48,-2690,-743,17.1,1498.2,81,5,1,10,5,14,0,0,0,0,17672,6.6,16605,187,36,2690,743,18.7,1767.2
4501459269,1,12,5,1,8,9,15,0,0,0,0,18315,7.0,18534,209,51,246,1266,20.9,1831.5,17,0,0,9,8,8,1,1,0,0,18069,6.8,17268,208,46,-246,-1266,20.8,1806.9
4505359839,0,17,3,0,1,9,0,0,0,0,0,13458,6.6,16195,221,36,-4232,-2456,22.1,1345.8,26,1,1,9,1,8,0,0,0,0,17690,7.2,18651,225,35,4232,2456,22.5,1769.0
4490117676,1,60,4,1,3,2,2,0,0,0,0,15271,7.0,18182,199,59,356,58,19.9,1527.1,16,0,0,2,3,2,0,0,0,0,14915,7.0,18124,232,39,-356,-58,23.2,1491.5
4517972804,1,17,2,1,6,3,6,1,1,0,0,17427,7.0,19221,249,63,1975,1433,24.9,1742.7,14,6,0,3,6,2,0,0,0,0,15452,7.0,17788,234,60,-1975,-1433,23.4,1545.2
4522327087,0,18,3,0,5,8,5,0,0,0,0,16007,7.2,18083,207,56,-1534,-167,20.7,1600.7,70,3,1,8,5,9,2,1,1,0,17541,6.8,18250,196,64,1534,167,19.6,1754.1
4523492555,1,13,3,1,4,1,5,1,1,0,0,16942,7.6,20255,261,72,2875,3035,26.1,1694.2,15,2,0,1,4,1,0,0,0,0,14067,6.8,17220,222,56,-2875,-3035,22.2,1406.7
4485773420,1,38,3,0,4,5,4,1,1,0,0,15184,6.8,17545,199,48,-700,906,19.9,1518.4,16,0,1,5,4,5,1,0,1,0,15884,6.6,16639,215,38,700,-906,21.5,1588.4
4478251083,0,17,2,0,11,11,8,1,1,0,0,17373,6.6,16452,178,41,-1768,-2230,17.8,1737.3,14,0,1,11,11,8,0,0,0,0,19141,7.2,18682,198,41,1768,2230,19.8,1914.1
4429858119,0,14,5,1,4,7,4,0,0,0,0,15220,6.4,16809,236,45,-2475,-2226,23.6,1522.0,19,3,0,7,4,9,0,0,0,0,17695,7.2,19035,247,64,2475,2226,24.7,1769.5
4524774054,1,17,4,0,9,5,13,0,0,0,0,17626,7.2,18770,219,44,2511,3602,21.9,1762.6,41,1,1,5,9,13,2,1,1,0,15115,6.0,15168,162,47,-2511,-3602,16.2,1511.5
4515483383,0,12,3,0,2,8,1,0,0,0,0,14183,7.0,17123,221,51,-4625,-1753,22.1,1418.3,15,2,1,8,2,12,1,1,0,0,18808,7.0,18876,248,56,4625,1753,24.8,1880.8
4434486038,0,15,4,0,8,11,7,0,0,0,0,17550,7.0,18186,229,48,-1499,-1282,22.9,1755.0,14,4,1,11,8,14,1,0,1,0,19049,7.0,19468,247,32,1499,1282,24.7,1904.9
4525546355,0,18,2,0,4,8,5,0,0,0,0,15470,7.0,17547,226,64,-2376,-1482,22.6,1547.0,15,5,1,8,4,13,1,1,0,0,17846,7.4,19029,248,48,2376,1482,24.8,1784.6
4478351147,0,13,3,0,4,11,0,0,0,0,0,14891,6.8,17683,218,59,-4035,-2639,21.8,1489.1,18,3,1,11,4,11,1,1,0,0,18926,7.4,20322,246,51,4035,2639,24.6,1892.6
4468973214,0,23,1,0,4,7,6,0,0,0,0,15210,6.6,16010,207,40,-2161,-3222,20.7,1521.0,35,1,1,7,4,8,2,1,1,0,17371,7.4,19232,214,72,2161,3222,21.4,1737.1
4459294938,1,14,4,0,7,2,6,0,0,0,0,16977,7.2,19637,209,64,1926,3774,20.9,1697.7,14,1,1,2,7,3,1,1,0,0,15051,6.4,15863,235,56,-1926,-3774,23.5,1505.1
4510920346,1,21,1,1,7,3,4,1,1,0,0,17911,7.2,18635,248,60,3969,1119,24.8,1791.1,14,3,0,3,7,2,0,0,0,0,13942,6.8,17516,164,37,-3969,-1119,16.4,1394.2
4427925743,0,15,4,1,3,6,2,0,0,0,0,13977,6.6,15961,185,48,-2707,-3132,18.5,1397.7,17,4,0,6,3,5,2,1,1,0,16684,7.4,19093,226,64,2707,3132,22.6,1668.4
4524310116,0,17,3,0,4,8,4,0,0,0,0,14722,6.6,17262,190,48,-2208,-2862,19.0,1472.2,15,1,1,8,4,4,2,1,1,0,16930,7.6,20124,210,72,2208,2862,21.0,1693.0
4486777926,0,18,4,1,6,6,8,0,0,0,0,15380,7.0,17373,193,55,-2064,-2639,19.3,1538.0,36,5,0,6,6,5,0,0,0,0,17444,7.6,20012,242,60,2064,2639,24.2,1744.4
4464183105,0,17,5,1,1,3,1,0,0,0,0,15221,6.8,17418,266,45,-179,-463,26.6,1522.1,14,4,0,3,1,4,1,1,0,0,15400,6.6,17881,240,46,179,463,24.0,1540.0
4472849009,0,21,2,1,5,6,5,2,1,1,0,15817,7.0,17992,218,43,-27,-371,21.8,1581.7,17,4,0,6,5,7,0,0,0,0,15844,7.2,18363,203,41,27,371,20.3,1584.4
4508028772,0,13,2,0,6,5,4,1,1,0,0,15655,6.8,17386,203,53,-693,-919,20.3,1565.5,14,1,1,5,6,5,0,0,0,0,16348,7.0,18305,234,56,693,919,23.4,1634.8
4525977517,1,16,5,0,6,4,6,1,1,0,0,15836,6.8,18034,216,43,75,-123,21.6,1583.6,14,3,1,4,6,1,0,0,0,0,15761,6.8,18157,254,38,-75,123,25.4,1576.1
4523339040,1,18,5,1,9,2,8,2,1,1,0,18318,7.2,19194,228,46,4446,3448,22.8,1831.8,20,1,0,2,9,4,0,0,0,0,13872,6.4,15746,188,41,-4446,-3448,18.8,1387.2
4524654966,0,43,8,1,6,13,6,0,0,0,0,15336,6.8,16216,196,44,-3534,-1814,19.6,1533.6,17,5,0,13,6,13,1,1,0,0,18870,7.0,18030,208,40,3534,1814,20.8,1887.0
4519775314,1,24,2,0,3,3,4,0,0,0,0,14979,7.0,17553,237,48,-1171,-496,23.7,1497.9,13,2,1,3,3,3,0,0,0,0,16150,7.0,18049,251,52,1171,496,25.1,1615.0
4499897772,1,14,0,1,7,8,10,1,0,1,1,18133,7.0,17764,215,46,1025,-1153,21.5,1813.3,14,0,0,8,7,5,1,1,0,0,17108,6.8,18917,218,54,-1025,1153,21.8,1710.8
4511735384,1,16,1,1,9,3,8,2,1,1,0,18599,7.2,20735,216,76,3821,4288,21.6,1859.9,34,1,0,3,9,5,0,0,0,0,14778,6.8,16447,187,56,-3821,-4288,18.7,1477.8
4510843873,1,16,1,0,5,9,5,2,1,1,1,18041,7.0,18637,221,60,786,1049,22.1,1804.1,15,3,1,9,5,14,0,0,0,0,17255,6.8,17588,213,33,-786,-1049,21.3,1725.5
4459773045,1,22,5,1,11,7,14,1,1,0,1,19465,7.0,17819,214,52,4013,2137,21.4,1946.5,14,1,0,7,11,8,0,0,0,0,15452,6.4,15682,182,29,-4013,-2137,18.2,1545.2
4478422383,1,17,0,1,8,7,8,1,1,0,0,17200,6.6,17501,226,36,528,-805,22.6,1720.0,13,1,0,7,8,7,0,0,0,0,16672,7.2,18306,199,69,-528,805,19.9,1667.2
4486943775,1,13,2,1,16,5,16,1,0,1,0,20380,7.2,20228,230,36,5330,4040,23.0,2038.0,18,2,0,5,16,3,1,1,0,0,15050,6.6,16188,173,44,-5330,-4040,17.3,1505.0
4523306081,0,15,3,0,8,12,11,0,0,0,0,17201,7.2,18755,207,30,-1817,-354,20.7,1720.1,55,3,1,12,8,13,1,1,0,0,19018,7.4,19109,201,46,1817,354,20.1,1901.8
4500139038,1,22,2,1,9,11,16,0,0,0,0,18398,6.8,17918,202,47,1235,-270,20.2,1839.8,44,4,0,11,9,15,1,1,0,0,17163,7.0,18188,197,48,-1235,270,19.7,1716.3
4481875944,1,14,2,0,7,11,7,0,0,0,0,15177,6.4,15795,152,36,-3891,-2689,15.2,1517.7,41,0,1,11,7,9,0,0,0,0,19068,7.2,18484,218,43,3891,2689,21.8,1906.8
4464520808,0,75,2,1,8,5,8,1,1,0,0,16801,7.2,19121,198,54,-209,417,19.8,1680.1,15,1,0,5,8,6,0,0,0,0,17010,7.0,18704,229,52,209,-417,22.9,1701.0
4517904549,1,18,2,0,3,5,3,1,1,0,0,15636,6.8,17293,220,63,-1086,-637,22.0,1563.6,40,4,1,5,3,10,1,0,1,0,16722,7.0,17930,216,51,1086,637,21.6,1672.2
4525230737,1,12,4,0,7,7,9,0,0,0,0,16696,6.8,17704,202,52,-422,-43,20.2,1669.6,28,1,1,7,7,10,2,1,1,0,17118,7.0,17747,189,53,422,43,18.9,1711.8
4524217548,0,17,1,0,5,10,6,0,0,0,0,16249,7.0,18383,213,59,-1796,-749,21.3,1624.9,16,2,1,10,5,15,1,1,0,0,18045,7.0,19132,214,44,1796,749,21.4,1804.5
4489152949,1,20,3,1,6,7,11,0,0,0,0,16535,6.8,17913,199,45,-847,11,19.9,1653.5,14,4,0,7,6,10,1,1,0,0,17382,6.8,17902,227,46,847,-11,22.7,1738.2
4491372975,1,35,2,1,9,3,12,2,1,1,1,19629,7.6,21016,232,59,3865,4032,23.2,1962.9,17,0,0,3,9,7,0,0,0,0,15764,6.8,16984,225,47,-3865,-4032,22.5,1576.4
4443034912,1,14,0,1,12,4,5,1,0,1,2,20018,7.6,20654,226,44,6489,4212,22.6,2001.8,13,1,0,4,12,0,1,1,0,0,13529,6.6,16442,172,37,-6489,-4212,17.2,1352.9
4524651202,0,14,3,1,6,7,4,0,0,0,0,16060,6.4,16764,200,60,-27,-1847,20.0,1606.0,87,3,0,7,6,7,1,1,0,0,16087,7.0,18611,194,53,27,1847,19.4,1608.7
4515616629,1,11,2,1,8,3,8,0,0,0,0,17628,7.2,18793,231,61,3539,2952,23.1,1762.8,123,2,0,3,8,4,0,0,0,0,14089,6.4,15841,195,46,-3539,-2952,19.5,1408.9
4477995331,0,66,2,1,8,8,13,0,0,0,0,17191,6.8,17401,188,56,654,478,18.8,1719.1,15,1,0,8,8,9,1,1,0,0,16537,6.6,16923,191,57,-654,-478,19.1,1653.7
4501131347,1,44,5,1,14,12,14,1,1,0,0,19418,6.8,18520,204,49,1698,2237,20.4,1941.8,21,5,0,12,14,11,1,0,1,0,17720,6.6,16283,167,51,-1698,-2237,16.7,1772.0
4461203281,0,17,3,0,1,9,2,0,0,0,0,13570,6.2,15620,194,52,-6578,-4807,19.4,1357.0,21,3,1,9,1,8,2,1,1,1,20148,7.2,20427,267,63,6578,4807,26.7,2014.8
4522480570,0,12,3,1,7,6,6,0,0,0,0,17197,7.2,18196,238,45,1125,-141,23.8,1719.7,38,0,0,6,7,6,0,0,0,0,16072,7.0,18337,205,65,-1125,141,20.5,1607.2
4520617887,0,19,3,1,6,6,6,0,0,0,0,15866,6.6,17209,207,45,-859,-1186,20.7,1586.6,17,4,0,6,6,10,0,0,0,0,16725,7.2,18395,245,66,859,1186,24.5,1672.5
4488357361,1,16,5,0,4,8,4,1,0,1,0,15767,7.0,17903,233,52,-953,-677,23.3,1576.7,19,5,1,8,4,8,0,0,0,0,16720,7.0,18580,226,40,953,677,22.6,1672.0
4513432258,1,14,2,1,8,2,9,1,0,1,0,17274,7.0,18134,233,39,3640,2348,23.3,1727.4,12,5,0,2,8,0,0,0,0,0,13634,6.4,15786,202,44,-3640,-2348,20.2,1363.4
4472839071,0,17,4,1,4,7,4,0,0,0,0,15025,6.6,16369,212,32,-1517,-1487,21.2,1502.5,30,7,0,7,4,5,0,0,0,0,16542,7.0,17856,221,29,1517,1487,22.1,1654.2
4505505523,0,18,2,1,11,16,19,0,0,0,0,17198,6.4,15293,156,32,-2830,-2212,15.6,1719.8,17,3,0,16,11,24,1,1,0,0,20028,6.8,17505,174,46,2830,2212,17.4,2002.8
4525562740,1,17,9,1,9,6,6,0,0,0,0,16749,6.6,17028,177,64,239,285,17.7,1674.9,19,6,0,6,9,5,0,0,0,0,16510,6.6,16743,219,59,-239,-285,21.9,1651.0
4520825058,1,64,3,0,7,2,7,1,1,0,0,17033,6.8,18063,225,41,2789,2000,22.5,1703.3,18,2,1,2,7,2,0,0,0,0,14244,6.4,16063,210,41,-2789,-2000,21.0,1424.4
4510437554,0,103,1,0,6,3,5,0,0,0,0,15846,6.8,18039,201,62,1481,996,20.1,1584.6,18,0,1,3,6,2,0,0,0,0,14365,7.0,17043,208,39,-1481,-996,20.8,1436.5
4484045621,1,40,1,1,10,7,16,2,1,1,0,18989,7.2,19584,201,67,2545,1695,20.1,1898.9,40,3,0,7,10,11,0,0,0,0,16444,7.0,17889,212,38,-2545,-1695,21.2,1644.4
4510942047,1,14,3,1,10,4,12,1,1,0,0,19017,7.2,19432,240,54,5117,4126,24.0,1901.7,15,5,0,4,10,4,0,0,0,0,13900,6.4,15306,193,34,-5117,-4126,19.3,1390.0
4525171151,0,14,3,0,4,6,4,1,1,0,0,15433,7.2,18889,218,66,-1629,-287,21.8,1543.3,16,1,1,6,4,4,0,0,0,0,17062,7.4,19176,249,42,1629,287,24.9,1706.2
4459614716,1,53,6,1,4,3,5,0,0,0,0,16441,7.0,18447,244,52,1254,400,24.4,1644.1,18,3,0,3,4,4,0,0,0,0,15187,6.8,18047,218,60,-1254,-400,21.8,1518.7
4492253992,0,15,3,0,4,11,5,0,0,0,0,14606,6.4,16104,173,59,-4405,-3304,17.3,1460.6,57,3,1,11,4,16,1,1,0,0,19011,7.2,19408,193,63,4405,3304,19.3,1901.1
4502220585,1,19,4,1,15,4,23,1,1,0,1,22134,7.6,20809,234,59,8151,5114,23.4,2213.4,15,2,0,4,15,6,0,0,0,0,13983,6.2,15695,176,34,-8151,-5114,17.6,1398.3
4457103291,0,11,3,0,5,9,5,0,0,0,0,14994,7.0,17924,188,48,-3155,-2773,18.8,1499.4,15,1,1,9,5,9,0,0,0,0,18149,7.4,20697,219,56,3155,2773,21.9,1814.9
4520889753,0,16,5,1,6,7,9,1,1,0,0,15303,6.6,16803,209,28,-1154,-1629,20.9,1530.3,21,1,0,7,6,8,0,0,0,0,16457,7.0,18432,207,44,1154,1629,20.7,1645.7
4511747596,0,15,2,1,12,8,18,0,0,0,0,18238,6.8,16827,189,32,1797,-723,18.9,1823.8,18,4,0,8,12,5,1,1,0,0,16441,6.8,17550,190,47,-1797,723,19.0,1644.1
4506306912,1,16,4,1,7,5,7,1,1,0,0,17106,7.2,18424,231,48,450,-219,23.1,1710.6,17,6,0,5,7,5,1,0,1,0,16656,7.0,18643,241,62,-450,219,24.1,1665.6
4464085930,0,30,0,1,9,9,9,0,0,0,0,17658,7.0,17546,214,47,108,-88,21.4,1765.8,16,2,0,9,9,8,1,0,1,0,17550,7.0,17634,235,36,-108,88,23.5,1755.0
4518113467,0,8,1,0,6,8,5,0,0,0,0,16373,7.2,18479,221,40,-2027,-114,22.1,1637.3,15,1,1,8,6,9,2,1,1,0,18400,7.0,18593,235,36,2027,114,23.5,1840.0
4492762371,1,16,4,1,13,6,18,1,1,0,0,20169,7.0,17549,205,52,4453,337,20.5,2016.9,20,0,0,6,13,9,0,0,0,0,15716,6.6,17212,162,52,-4453,-337,16.2,1571.6
4515181704,1,17,3,1,7,4,3,0,0,0,0,17116,7.2,18779,245,52,951,-101,24.5,1711.6,16,1,0,4,7,3,1,0,1,0,16165,7.2,18880,252,53,-951,101,25.2,1616.5
4495755195,1,11,0,0,11,8,11,1,0,1,0,18817,7.0,17845,192,54,311,559,19.2,1881.7,16,1,1,8,11,6,0,0,0,1,18506,6.8,17286,228,36,-311,-559,22.8,1850.6
4497475863,0,35,2,1,6,5,6,1,1,0,0,15765,7.0,17647,214,45,-164,-313,21.4,1576.5,12,2,0,5,6,6,0,0,0,0,15929,6.8,17960,218,47,164,313,21.8,1592.9
4524754524,0,15,2,0,3,8,2,0,0,0,0,13875,6.6,16394,209,36,-3866,-1987,20.9,1387.5,23,3,1,8,3,10,1,1,0,0,17741,7.2,18381,227,47,3866,1987,22.7,1774.1
4468926711,1,15,1,0,4,8,4,0,0,0,0,15337,6.6,16778,217,40,-2811,-2298,21.7,1533.7,17,2,1,8,4,7,1,1,0,0,18148,7.2,19076,224,56,2811,2298,22.4,1814.8
4495304851,0,15,1,0,8,6,3,0,0,0,0,16678,7.0,18875,216,64,1079,1586,21.6,1667.8,15,5,1,6,8,3,1,1,0,0,15599,6.8,17289,220,32,-1079,-1586,22.0,1559.9
4524955367,1,17,3,0,2,6,2,1,1,0,0,14341,6.8,17715,233,52,-1929,-680,23.3,1434.1,15,4,1,6,2,8,0,0,0,0,16270,7.0,18395,233,44,1929,680,23.3,1627.0
4479126740,0,61,3,0,8,10,8,0,0,0,0,16780,6.8,17484,209,39,-1226,48,20.9,1678.0,18,4,1,10,8,12,1,1,0,0,18006,6.8,17436,225,36,1226,-48,22.5,1800.6
4526921944,1,16,5,0,7,6,9,1,1,0,0,17108,7.0,18548,230,59,990,1798,23.0,1710.8,51,6,1,6,7,6,0,0,0,0,16118,6.6,16750,218,48,-990,-1798,21.8,1611.8
4516964938,0,14,5,0,10,11,10,0,0,0,0,17702,6.4,16589,198,44,-1478,-1657,19.8,1770.2,16,2,1,11,10,14,0,0,0,0,19180,6.8,18246,202,52,1478,1657,20.2,1918.0
4492085099,0,16,2,1,5,5,4,1,0,1,0,15745,6.8,17698,203,60,-859,361,20.3,1574.5,15,5,0,5,5,8,1,1,0,0,16604,6.8,17337,220,52,859,-361,22.0,1660.4
4508637954,1,15,2,0,9,2,15,0,0,0,0,18485,7.2,18688,232,48,4318,2821,23.2,1848.5,17,1,1,2,9,3,1,0,1,0,14167,6.4,15867,197,44,-4318,-2821,19.7,1416.7
4495106153,0,15,2,1,10,4,11,2,1,1,0,17816,6.8,18684,202,58,1953,1494,20.2,1781.6,16,5,0,4,10,6,0,0,0,0,15863,7.0,17190,224,41,-1953,-1494,22.4,1586.3
4518276531,0,17,4,0,1,9,0,0,0,0,0,13806,6.4,15551,216,47,-4145,-3714,21.6,1380.6,20,5,1,9,1,12,2,1,1,0,17951,7.6,19265,232,50,4145,3714,23.2,1795.1
4518449661,0,15,1,0,3,7,4,0,0,0,0,15598,6.8,17735,220,69,-1293,-260,22.0,1559.8,25,1,1,7,3,6,1,1,0,0,16891,7.0,17995,237,42,1293,260,23.7,1689.1
4462203064,1,15,6,0,7,4,8,0,0,0,0,17008,7.2,18978,216,44,1238,1037,21.6,1700.8,18,2,1,4,7,5,1,1,0,0,15770,6.8,17941,231,52,-1238,-1037,23.1,1577.0
4513103663,0,14,2,0,4,9,4,0,0,0,0,14743,6.4,15965,197,50,-3465,-3351,19.7,1474.3,20,3,1,9,4,10,1,1,0,0,18208,7.4,19316,224,74,3465,3351,22.4,1820.8
4510707082,1,13,1,1,8,8,7,1,1,0,0,16493,7.0,17450,175,44,-862,-1734,17.5,1649.3,32,2,0,8,8,5,1,0,1,0,17355,7.2,19184,223,55,862,1734,22.3,1735.5
4527960459,1,16,4,1,7,1,5,1,0,1,0,17170,7.0,19211,251,54,3234,2427,25.1,1717.0,21,2,0,1,7,1,0,0,0,0,13936,6.8,16784,203,68,-3234,-2427,20.3,1393.6
4523336843,1,15,0,1,6,2,5,1,0,1,0,17338,7.4,19907,256,63,2533,1568,25.6,1733.8,16,5,0,2,6,3,0,0,0,0,14805,7.2,18339,242,53,-2533,-1568,24.2,1480.5
4522648784,0,18,3,0,4,7,2,0,0,0,0,15046,6.6,17140,208,48,-1208,-614,20.8,1504.6,37,4,1,7,4,5,1,1,0,0,16254,7.0,17754,227,44,1208,614,22.7,1625.4
4521575366,0,47,2,0,7,7,8,0,0,0,0,17151,6.8,17777,193,49,-1122,-926,19.3,1715.1,12,3,1,7,7,6,2,1,1,1,18273,7.2,18703,234,55,1122,926,23.4,1827.3
4526752854,0,15,5,0,9,4,7,0,0,0,0,16847,7.0,19212,211,45,1843,3584,21.1,1684.7,17,2,1,4,9,4,0,0,0,0,15004,6.2,15628,194,50,-1843,-3584,19.4,1500.4
4509591728,1,15,3,0,3,9,3,0,0,0,0,15477,7.0,17532,223,56,-1579,-655,22.3,1547.7,61,1,1,9,3,12,1,0,1,0,17056,7.0,18187,192,52,1579,655,19.2,1705.6
4519675150,0,20,4,0,7,3,8,1,1,0,0,16628,6.8,17255,215,52,-105,1234,21.5,1662.8,18,2,1,3,7,5,1,0,1,1,16733,6.2,16021,213,46,105,-1234,21.3,1673.3
4481234929,1,24,1,1,8,4,8,0,0,0,0,17448,6.8,18315,242,48,2551,1754,24.2,1744.8,17,1,0,4,8,7,0,0,0,0,14897,6.6,16561,195,46,-2551,-1754,19.5,1489.7
4524703724,1,21,4,1,5,4,4,0,0,0,0,16005,7.0,17430,228,38,1561,621,22.8,1600.5,20,2,0,4,5,6,1,1,0,0,14444,6.6,16809,187,47,-1561,-621,18.7,1444.4
4524479196,0,11,2,0,1,8,2,0,0,0,0,13841,6.8,16368,216,49,-5048,-4145,21.6,1384.1,18,0,1,8,1,6,1,1,0,0,18889,7.4,20513,268,53,5048,4145,26.8,1888.9
4516068485,0,37,4,0,0,10,0,0,0,0,0,12837,6.2,15086,196,36,-5369,-5193,19.6,1283.7,20,3,1,10,0,10,2,1,1,0,18206,7.2,20279,242,47,5369,5193,24.2,1820.6
4514051378,1,12,4,0,11,9,11,1,1,0,0,17774,7.0,18440,180,49,-76,1386,18.0,1777.4,19,0,1,9,11,9,0,0,0,0,17850,6.8,17054,190,60,76,-1386,19.0,1785.0
4521761275,1,17,1,0,4,12,3,0,0,0,0,15716,6.8,16980,225,39,-3446,-3817,22.5,1571.6,15,0,1,12,4,10,2,1,1,0,19162,7.8,20797,239,59,3446,3817,23.9,1916.2
4481919426,0,14,2,0,9,6,13,1,1,0,0,17235,6.8,17249,196,47,1177,-691,19.6,1723.5,16,4,1,6,9,7,0,0,0,0,16058,6.8,17940,232,37,-1177,691,23.2,1605.8
4465445670,0,14,4,1,9,1,5,0,0,0,0,17773,7.2,18937,236,46,4257,2902,23.6,1777.3,14,3,0,1,9,1,0,0,0,0,13516,6.4,16035,204,53,-4257,-2902,20.4,1351.6
4518248972,0,15,4,1,4,6,7,0,0,0,0,15399,7.0,17209,217,47,-1589,-575,21.7,1539.9,18,3,0,6,4,11,1,1,0,0,16988,7.0,17784,210,48,1589,575,21.0,1698.8
4487355594,1,11,3,1,11,7,8,0,0,0,0,18288,7.4,19406,207,57,2616,3108,20.7,1828.8,12,0,0,7,11,9,1,1,0,0,15672,6.6,16298,177,44,-2616,-3108,17.7,1567.2
4509478131,0,16,6,0,5,5,8,0,0,0,0,16930,7.2,18587,237,52,928,-633,23.7,1693.0,20,4,1,5,5,3,1,1,0,0,16002,7.2,19220,241,56,-928,633,24.1,1600.2
4496543857,0,15,5,0,9,10,9,0,0,0,0,17987,6.8,17683,209,41,-368,-612,20.9,1798.7,17,2,1,10,9,11,0,0,0,0,18355,7.2,18295,236,54,368,612,23.6,1835.5
4511615760,1,22,2,0,6,3,10,0,0,0,0,17141,7.2,19142,232,54,2378,2190,23.2,1714.1,15,2,1,3,6,1,1,1,0,0,14763,6.8,16952,206,56,-2378,-2190,20.6,1476.3
4484202806,0,12,3,0,4,10,1,0,0,0,0,14816,6.6,16519,218,46,-4490,-3582,21.8,1481.6,15,0,1,10,4,6,2,1,1,1,19306,7.4,20101,247,56,4490,3582,24.7,1930.6
4513373886,1,17,1,1,4,5,2,0,0,0,0,15226,6.8,17774,168,67,-1667,-654,16.8,1522.6,16,0,0,5,4,6,0,0,0,0,16893,6.8,18428,227,55,1667,654,22.7,1689.3
4510124287,1,17,3,0,6,6,5,0,0,0,0,17262,7.0,18939,222,64,1371,2221,22.2,1726.2,21,2,1,6,6,7,1,1,0,0,15891,6.6,16718,195,48,-1371,-2221,19.5,1589.1
4520606838,0,57,1,1,4,3,7,0,0,0,0,14565,6.4,16719,192,42,179,-417,19.2,1456.5,14,2,0,3,4,2,1,1,0,0,14386,6.6,17136,199,58,-179,417,19.9,1438.6
4519612989,0,27,2,0,10,12,13,1,1,0,0,17283,6.4,16235,184,36,-845,-1743,18.4,1728.3,14,5,1,12,10,7,0,0,0,0,18128,6.8,17978,208,68,845,1743,20.8,1812.8
4508992127,0,16,5,1,4,10,4,0,0,0,0,15302,6.8,16647,210,55,-3051,-2123,21.0,1530.2,24,4,0,10,4,12,1,1,0,0,18353,7.0,18770,215,50,3051,2123,21.5,1835.3
4472113530,1,13,0,1,8,5,5,0,0,0,0,16979,7.2,18700,213,48,1486,991,21.3,1697.9,14,0,0,5,8,3,0,0,0,0,15493,7.0,17709,200,46,-1486,-991,20.0,1549.3
4527865649,0,17,2,0,7,8,9,1,0,1,0,17394,6.8,17904,261,32,188,-676,26.1,1739.4,29,4,1,8,7,7,0,0,0,0,17206,7.0,18580,212,56,-188,676,21.2,1720.6
4451625868,0,19,1,0,3,8,1,0,0,0,0,14294,7.0,17770,206,51,-3738,-1260,20.6,1429.4,14,2,1,8,3,8,2,1,1,0,18032,7.2,19030,229,55,3738,1260,22.9,1803.2
4497452611,0,19,7,0,3,4,5,0,0,0,0,15347,6.8,17612,243,48,-704,-193,24.3,1534.7,14,2,1,4,3,3,1,1,0,0,16051,6.8,17805,220,60,704,193,22.0,1605.1
4520610371,1,17,3,0,9,3,11,0,0,0,0,16954,6.8,17771,221,32,2589,2509,22.1,1695.4,31,5,1,3,9,4,1,1,0,0,14365,6.4,15262,187,46,-2589,-2509,18.7,1436.5
4524820601,1,11,1,1,9,11,11,0,0,0,0,17322,6.4,16229,182,52,-956,-1451,18.2,1732.2,14,1,0,11,9,12,1,1,0,0,18278,6.8,17680,207,49,956,1451,20.7,1827.8
4457232742,1,15,2,1,11,3,13,1,1,0,0,17655,7.2,18905,208,44,1906,1369,20.8,1765.5,13,0,0,3,11,3,0,0,0,0,15749,7.0,17536,221,57,-1906,-1369,22.1,1574.9
4433310925,1,16,1,1,5,2,5,0,0,0,0,16747,7.2,19858,250,64,2126,1070,25.0,1674.7,10,2,0,2,5,1,0,0,0,0,14621,7.0,18788,227,60,-2126,-1070,22.7,1462.1
4506292782,1,13,0,1,12,3,16,1,1,0,0,19443,7.2,19743,254,48,5349,4131,25.4,1944.3,17,2,0,3,12,3,0,0,0,0,14094,6.6,15612,190,48,-5349,-4131,19.0,1409.4
4508742388,1,16,2,1,3,5,3,1,1,0,0,15735,7.0,18331,233,52,539,774,23.3,1573.5,19,2,0,5,3,4,0,0,0,0,15196,7.0,17557,220,40,-539,-774,22.0,1519.6
4475220338,0,35,1,0,3,10,1,1,0,1,0,15084,6.8,17618,188,54,-3847,-933,18.8,1508.4,13,1,1,10,3,11,1,1,0,1,18931,6.8,18551,232,37,3847,933,23.2,1893.1
4473962566,1,17,2,0,9,7,10,1,1,0,0,17205,7.0,18124,218,40,721,2077,21.8,1720.5,16,1,1,7,9,11,0,0,0,0,16484,6.4,16047,212,39,-721,-2077,21.2,1648.4
4523081068,1,16,4,0,7,8,5,0,0,0,0,15646,7.0,17325,192,35,-1528,-1421,19.2,1564.6,26,4,1,8,7,8,1,1,0,0,17174,7.2,18746,225,42,1528,1421,22.5,1717.4
4518881307,0,17,2,0,3,7,5,0,0,0,0,14676,6.6,16668,170,59,-1563,-1232,17.0,1467.6,18,1,1,7,3,3,1,1,0,0,16239,6.8,17900,201,52,1563,1232,20.1,1623.9
4519998999,0,14,2,0,0,4,0,1,0,1,0,13805,6.8,17253,221,52,-2009,-2396,22.1,1380.5,59,1,1,4,0,5,1,1,0,0,15814,7.2,19649,243,59,2009,2396,24.3,1581.4
4522519363,1,16,4,0,5,3,4,1,1,0,0,16338,7.2,19137,234,60,1106,1309,23.4,1633.8,18,1,1,3,5,1,0,0,0,0,15232,6.8,17828,228,60,-1106,-1309,22.8,1523.2
4513996335,0,41,3,1,7,7,7,1,1,0,0,16491,6.6,16774,190,60,453,-1745,19.0,1649.1,16,6,0,7,7,0,0,0,0,0,16038,7.0,18519,238,51,-453,1745,23.8,1603.8
4518585607,0,28,3,0,3,7,3,0,0,0,0,15423,7.2,18648,232,52,-2055,-860,23.2,1542.3,18,2,1,7,3,10,1,1,0,0,17478,7.2,19508,258,52,2055,860,25.8,1747.8
4520303900,1,14,1,0,5,3,5,1,0,1,1,17531,7.4,19484,241,46,2351,1317,24.1,1753.1,12,2,1,3,5,3,1,1,0,0,15180,7.0,18167,223,44,-2351,-1317,22.3,1518.0
4522642562,0,16,3,1,10,7,5,1,1,0,0,17454,6.8,18029,204,58,617,128,20.4,1745.4,12,1,0,7,10,5,0,0,0,0,16837,6.8,17901,178,60,-617,-128,17.8,1683.7
4522528585,1,14,3,0,8,8,5,1,1,0,0,17421,7.4,19535,244,49,-108,1254,24.4,1742.1,14,2,1,8,8,9,0,0,0,0,17529,7.0,18281,212,58,108,-1254,21.2,1752.9
4513035037,0,26,2,0,3,10,3,0,0,0,0,14983,7.0,17248,203,44,-3217,-1601,20.3,1498.3,12,4,1,10,3,12,2,1,1,0,18200,7.0,18849,223,51,3217,1601,22.3,1820.0
4521233015,1,16,2,1,14,6,11,1,1,0,0,18537,7.2,19024,200,48,1809,1633,20.0,1853.7,15,1,0,6,14,5,0,0,0,0,16728,6.8,17391,193,64,-1809,-1633,19.3,1672.8
4524577264,0,16,5,0,4,5,7,0,0,0,0,15820,7.0,18001,242,58,-758,-392,24.2,1582.0,16,3,1,5,4,4,2,1,1,0,16578,7.2,18393,229,52,758,392,22.9,1657.8
4500568254,1,14,3,1,6,3,6,0,0,0,0,16195,7.0,17940,214,35,2254,1870,21.4,1619.5,14,1,0,3,6,1,0,0,0,0,13941,6.2,16070,193,56,-2254,-1870,19.3,1394.1
4520786443,0,13,1,1,7,4,7,1,0,1,0,16620,7.2,18824,211,48,273,255,21.1,1662.0,13,2,0,4,7,7,1,1,0,0,16347,7.0,18569,226,67,-273,-255,22.6,1634.7
4516789805,1,17,2,0,9,4,8,1,0,1,1,19484,7.2,20010,267,52,3538,2904,26.7,1948.4,16,4,1,4,9,4,1,1,0,0,15946,6.6,17106,230,52,-3538,-2904,23.0,1594.6
4524303571,0,124,3,1,5,4,6,1,0,1,0,16243,7.0,18154,225,51,1034,706,22.5,1624.3,17,4,0,4,5,2,0,0,0,0,15209,6.8,17448,227,47,-1034,-706,22.7,1520.9
4492351873,0,15,0,1,10,10,8,0,0,0,1,18544,6.4,17072,182,60,1060,7,18.2,1854.4,39,2,0,10,10,11,1,1,0,0,17484,6.8,17065,174,36,-1060,-7,17.4,1748.4
4527853173,0,17,0,0,2,8,1,0,0,0,0,13446,6.4,15500,190,32,-4676,-3551,19.0,1344.6,10,6,1,8,2,9,2,1,1,0,18122,7.2,19051,243,50,4676,3551,24.3,1812.2
4524850374,0,26,3,0,8,8,8,0,0,0,0,16357,6.6,16464,193,37,-232,97,19.3,1635.7,16,2,1,8,8,8,1,1,0,0,16589,6.6,16367,196,56,232,-97,19.6,1658.9
4470773744,0,12,2,1,5,12,5,2,1,1,0,16347,6.6,17442,212,51,-3529,-1509,21.2,1634.7,12,5,0,12,5,15,0,0,0,1,19876,7.4,18951,214,52,3529,1509,21.4,1987.6
4434652049,0,18,1,1,9,7,8,0,0,0,0,17875,7.0,18320,203,43,2561,1875,20.3,1787.5,14,0,0,7,9,6,0,0,0,0,15314,6.6,16445,179,32,-2561,-1875,17.9,1531.4
4523523505,1,12,2,1,7,1,12,1,1,0,0,17149,7.0,19250,216,53,3370,2895,21.6,1714.9,15,0,0,1,7,0,0,0,0,0,13779,6.4,16355,209,52,-3370,-2895,20.9,1377.9
4516073213,1,10,1,1,8,7,5,1,1,0,0,17325,7.0,19648,246,55,744,1657,24.6,1732.5,15,0,0,7,8,6,1,0,1,0,16581,6.8,17991,216,36,-744,-1657,21.6,1658.1
4521143475,0,15,5,0,9,8,7,1,0,1,1,19084,6.8,17286,225,38,2445,-81,22.5,1908.4,28,3,1,8,9,5,1,1,0,0,16639,6.8,17367,189,68,-2445,81,18.9,1663.9
4518069601,0,14,2,0,5,6,7,0,0,0,0,15078,6.6,16578,202,28,-1018,-828,20.2,1507.8,15,0,1,6,5,6,1,1,0,0,16096,6.8,17406,222,38,1018,828,22.2,1609.6
4521934653,1,15,1,1,9,7,12,0,0,0,0,17704,7.0,18183,196,68,639,1171,19.6,1770.4,15,1,0,7,9,10,0,0,0,0,17065,6.4,17012,208,39,-639,-1171,20.8,1706.5
4474783005,0,16,2,0,6,5,6,0,0,0,0,16496,7.0,18365,244,48,120,1543,24.4,1649.6,19,0,1,5,6,14,1,1,0,0,16376,6.6,16822,206,70,-120,-1543,20.6,1637.6
4492671924,1,20,2,1,6,4,5,1,1,0,0,16229,7.2,18988,200,62,164,486,20.0,1622.9,15,3,0,4,6,4,0,0,0,0,16065,7.2,18502,230,54,-164,-486,23.0,1606.5
4495019552,0,17,4,0,3,4,5,1,1,0,0,16001,7.2,18372,265,56,-54,616,26.5,1600.1,20,3,1,4,3,6,0,0,0,0,16055,6.6,17756,223,54,54,-616,22.3,1605.5
4504998560,1,13,1,1,9,10,10,0,0,0,0,17827,7.2,18573,216,35,24,983,21.6,1782.7,16,3,0,10,9,11,1,0,1,0,17803,6.8,17590,204,52,-24,-983,20.4,1780.3
4477637530,0,39,0,1,2,9,3,1,0,1,0,14157,6.4,16183,198,48,-3421,-2978,19.8,1415.7,16,3,0,9,2,10,1,1,0,0,17578,7.2,19161,238,48,3421,2978,23.8,1757.8
4521031841,0,12,0,0,1,6,0,1,1,0,0,14112,6.8,17265,232,48,-2720,-2419,23.2,1411.2,52,2,1,6,1,4,1,0,1,0,16832,7.4,19684,247,57,2720,2419,24.7,1683.2
4498445484,0,17,3,0,6,7,2,1,1,0,1,17046,7.2,18406,197,76,-190,-576,19.7,1704.6,15,5,1,7,6,5,1,0,1,0,17236,7.2,18982,229,53,190,576,22.9,1723.6
4419367000,1,41,3,0,4,17,4,0,0,0,0,15488,6.6,16539,184,47,-4903,-3146,18.4,1548.8,23,6,1,17,4,16,1,1,0,0,20391,7.4,19685,204,48,4903,3146,20.4,2039.1
4523435488,1,12,1,0,10,10,9,1,0,1,0,17566,7.2,18896,183,48,-528,-296,18.3,1756.6,13,1,1,10,10,5,1,1,0,0,18094,7.2,19192,228,60,528,296,22.8,1809.4
4491563778,1,68,19,1,9,3,9,1,1,0,0,17913,7.0,19123,249,56,2185,1440,24.9,1791.3,36,2,0,3,9,5,0,0,0,0,15728,6.6,17683,231,48,-2185,-1440,23.1,1572.8
4489559952,1,17,6,0,9,9,9,0,0,0,0,17898,7.0,18398,231,52,-113,-116,23.1,1789.8,39,5,1,9,9,11,1,1,0,0,18011,7.2,18514,218,52,113,116,21.8,1801.1
4501126526,1,14,0,1,6,4,12,2,1,1,0,16939,7.0,17733,211,56,1419,731,21.1,1693.9,18,3,0,4,6,6,0,0,0,0,15520,6.6,17002,227,54,-1419,-731,22.7,1552.0
4506975246,0,50,2,0,5,8,2,0,0,0,0,16304,7.0,18344,222,84,-890,-1261,22.2,1630.4,15,2,1,8,5,5,2,1,1,0,17194,7.4,19605,218,52,890,1261,21.8,1719.4
4410382729,1,14,2,1,6,5,9,0,0,0,0,15448,6.8,16856,180,47,58,203,18.0,1544.8,39,4,0,5,6,6,1,1,0,0,15390,6.6,16653,201,48,-58,-203,20.1,1539.0
4526208806,0,16,1,1,6,8,6,0,0,0,0,15186,6.8,16381,204,24,-2666,-1972,20.4,1518.6,38,4,0,8,6,14,1,1,0,0,17852,7.0,18353,218,57,2666,1972,21.8,1785.2
4523772935,1,18,0,1,6,6,5,0,0,0,0,16266,7.0,17321,207,44,927,-58,20.7,1626.6,9,2,0,6,6,4,1,1,0,0,15339,6.8,17379,201,46,-927,58,20.1,1533.9
4477855283,1,18,2,1,15,7,17,1,1,0,1,20932,7.2,19304,233,48,4217,1384,23.3,2093.2,32,4,0,7,15,8,0,0,0,0,16715,7.0,17920,188,64,-4217,-1384,18.8,1671.5
4515649293,1,13,1,1,4,8,8,0,0,0,0,15352,6.4,15672,193,46,-1702,-1490,19.3,1535.2,15,1,0,8,4,13,1,1,0,0,17054,6.6,17162,191,44,1702,1490,19.1,1705.4
4477428362,1,12,1,1,3,5,3,0,0,0,0,15708,6.8,17721,226,52,-564,-1862,22.6,1570.8,16,4,0,5,3,5,1,1,0,0,16272,7.2,19583,243,60,564,1862,24.3,1627.2
4454039126,0,18,4,0,7,10,9,0,0,0,0,16923,6.8,17782,224,36,-673,568,22.4,1692.3,44,6,1,10,7,13,1,1,0,0,17596,7.0,17214,199,42,673,-568,19.9,1759.6
4453471235,1,39,2,0,4,6,4,0,0,0,0,15462,7.2,18980,239,55,-1870,-71,23.9,1546.2,20,2,1,6,4,6,1,1,0,0,17332,7.2,19051,238,60,1870,71,23.8,1733.2
4525023717,0,15,1,1,6,5,4,0,0,0,0,16287,6.6,17787,226,52,25,2,22.6,1628.7,13,2,0,5,6,9,0,0,0,0,16262,6.8,17785,226,45,-25,-2,22.6,1626.2
4525188485,1,14,2,1,6,9,4,0,0,0,0,16978,6.8,17957,229,60,-1589,-2907,22.9,1697.8,34,1,0,9,6,11,1,0,1,0,18567,7.8,20864,193,75,1589,2907,19.3,1856.7
4452202569,1,53,4,0,7,11,10,0,0,0,0,16308,6.8,16771,189,44,-1751,-2784,18.9,1630.8,40,1,1,11,7,9,1,0,1,0,18059,7.4,19555,200,58,1751,2784,20.0,1805.9
4499945956,0,12,6,1,5,8,4,0,0,0,0,16116,6.8,16953,233,43,-89,-953,23.3,1611.6,16,2,0,8,5,3,1,1,0,0,16205,6.8,17906,213,52,89,953,21.3,1620.5
4526199603,0,15,3,0,5,15,6,0,0,0,0,15147,6.4,15110,201,33,-4470,-3848,20.1,1514.7,19,0,1,15,5,20,1,1,0,0,19617,7.4,18958,193,50,4470,3848,19.3,1961.7
4454104065,1,19,4,0,10,5,8,0,0,0,0,17907,7.4,19004,203,43,1227,2404,20.3,1790.7,38,7,1,5,10,11,0,0,0,0,16680,6.6,16600,218,40,-1227,-2404,21.8,1668.0
4494773466,0,16,0,1,5,9,7,0,0,0,0,16163,6.8,16772,190,52,-819,-1926,19.0,1616.3,48,6,0,9,5,8,0,0,0,0,16982,7.0,18698,225,50,819,1926,22.5,1698.2
4490954687,1,57,2,1,8,5,7,1,0,1,0,16776,7.0,18113,207,64,907,-86,20.7,1677.6,18,2,0,5,8,8,1,1,0,0,15869,7.0,18199,228,42,-907,86,22.8,1586.9
4511790029,0,15,4,0,5,10,7,0,0,0,0,15381,6.4,16749,202,51,-2099,-1505,20.2,1538.1,19,4,1,10,5,15,1,1,0,0,17480,7.0,18254,206,52,2099,1505,20.6,1748.0
4504703717,0,19,2,1,6,7,7,1,0,1,0,16050,6.8,17391,191,48,-513,-1056,19.1,1605.0,97,4,0,7,6,10,0,0,0,0,16563,6.8,18447,235,36,513,1056,23.5,1656.3
4527260532,1,18,5,0,10,6,17,0,0,0,0,16982,6.8,17597,187,46,1093,770,18.7,1698.2,18,1,1,6,10,4,0,0,0,0,15889,6.6,16827,222,44,-1093,-770,22.2,1588.9
4495556599,1,38,4,0,7,3,6,0,0,0,0,16738,7.4,19318,219,61,1031,1909,21.9,1673.8,15,3,1,3,7,1,1,1,0,0,15707,7.0,17409,218,61,-1031,-1909,21.8,1570.7
4527222225,0,42,3,0,7,4,5,2,1,1,0,16468,6.8,17897,224,44,142,-58,22.4,1646.8,18,8,1,4,7,6,0,0,0,0,16326,7.0,17955,209,64,-142,58,20.9,1632.6
4436737489,0,17,0,0,9,8,7,0,0,0,0,17061,7.0,18530,197,42,744,461,19.7,1706.1,34,2,1,8,9,14,0,0,0,0,16317,7.0,18069,178,34,-744,-461,17.8,1631.7
4506682192,0,11,2,0,3,6,1,0,0,0,0,13899,6.4,16444,202,36,-3238,-2465,20.2,1389.9,14,4,1,6,3,7,1,1,0,0,17137,7.2,18909,261,45,3238,2465,26.1,1713.7
4436047173,0,17,1,1,9,6,11,0,0,0,0,17416,7.2,18429,208,44,-367,-1771,20.8,1741.6,13,4,0,6,9,6,1,1,0,0,17783,7.4,20200,243,68,367,1771,24.3,1778.3
4519665715,0,15,2,0,8,9,5,0,0,0,0,16355,6.8,17998,198,59,-994,266,19.8,1635.5,16,4,1,9,8,9,1,1,0,0,17349,6.8,17732,202,40,994,-266,20.2,1734.9
4521293545,1,17,1,1,6,2,5,1,0,1,0,17834,7.2,19145,276,44,3797,2242,27.6,1783.4,10,1,0,2,6,3,1,1,0,0,14037,6.8,16903,202,48,-3797,-2242,20.2,1403.7
4521828179,0,15,2,0,8,9,10,1,1,0,0,17617,7.0,18094,217,50,685,1449,21.7,1761.7,14,0,1,9,8,12,0,0,0,0,16932,6.6,16645,180,56,-685,-1449,18.0,1693.2
4495445064,0,17,2,0,5,8,5,0,0,0,0,14803,6.8,17434,177,37,-2454,-1437,17.7,1480.3,37,4,1,8,5,6,1,1,0,0,17257,7.0,18871,219,52,2454,1437,21.9,1725.7
4483760431,1,11,1,0,8,5,10,2,1,1,0,17823,7.4,19752,215,64,1014,950,21.5,1782.3,9,1,1,5,8,5,0,0,0,0,16809,7.0,18802,219,75,-1014,-950,21.9,1680.9
4517672775,1,15,1,1,7,3,11,1,1,0,0,17072,7.0,19087,227,52,1782,1234,22.7,1707.2,11,3,0,3,7,1,0,0,0,0,15290,7.0,17853,212,61,-1782,-1234,21.2,1529.0
4525780504,0,13,2,0,3,2,6,0,0,0,0,14509,6.8,16800,191,52,-1749,-1247,19.1,1450.9,16,3,1,2,3,3,2,1,1,0,16258,6.8,18047,251,65,1749,1247,25.1,1625.8
4523270245,1,15,0,1,3,2,4,0,0,0,0,15719,7.4,19029,230,60,753,263,23.0,1571.9,13,0,0,2,3,3,1,1,0,0,14966,7.2,18766,236,63,-753,-263,23.6,1496.6
4523814750,1,17,4,1,7,3,4,1,0,1,0,17666,7.0,18167,240,41,3198,1428,24.0,1766.6,17,3,0,3,7,7,1,1,0,0,14468,6.6,16739,201,40,-3198,-1428,20.1,1446.8
4475217801,1,21,3,1,5,2,4,0,0,0,0,16350,7.0,18701,245,53,1290,1337,24.5,1635.0,37,6,0,2,5,2,0,0,0,0,15060,6.8,17364,236,54,-1290,-1337,23.6,1506.0
4489550843,1,16,2,1,6,3,5,1,1,0,0,16931,7.0,18085,225,54,2443,1566,22.5,1693.1,15,2,0,3,6,4,0,0,0,0,14488,6.4,16519,201,61,-2443,-1566,20.1,1448.8
4483304287,1,92,3,0,6,4,7,1,1,0,0,16541,7.0,19056,249,44,1294,1165,24.9,1654.1,13,1,1,4,6,6,0,0,0,0,15247,7.0,17891,211,50,-1294,-1165,21.1,1524.7
4444878201,1,23,3,1,14,9,18,1,1,0,0,20909,7.4,19188,210,52,3193,1212,21.0,2090.9,14,3,0,9,14,9,0,0,0,0,17716,7.0,17976,183,53,-3193,-1212,18.3,1771.6
4522440155,0,15,3,0,1,2,1,1,1,0,0,15216,7.2,18663,251,56,99,-174,25.1,1521.6,12,2,1,2,1,5,0,0,0,0,15117,7.0,18837,217,60,-99,174,21.7,1511.7
4515522584,1,19,1,1,9,5,10,1,0,1,1,19294,7.0,18363,234,54,4570,2205,23.4,1929.4,13,4,0,5,9,8,0,0,0,0,14724,6.6,16158,162,46,-4570,-2205,16.2,1472.4
4523640765,1,15,2,1,4,0,3,1,1,0,0,15282,6.8,17848,211,45,1629,677,21.1,1528.2,38,0,0,0,4,0,0,0,0,0,13653,6.8,17171,246,44,-1629,-677,24.6,1365.3
4407776093,1,117,8,1,6,1,7,1,1,0,0,16036,6.8,17948,200,56,2083,1282,20.0,1603.6,20,6,0,1,6,2,0,0,0,0,13953,6.8,16666,221,46,-2083,-1282,22.1,1395.3
4521820831,1,17,4,1,6,3,2,1,0,1,0,17149,7.0,18751,257,57,2610,1716,25.7,1714.9,16,3,0,3,6,2,1,1,0,0,14539,6.6,17035,203,49,-2610,-1716,20.3,1453.9
4527454309,0,60,2,1,10,7,7,2,1,1,0,18226,7.2,18871,211,53,1063,1153,21.1,1822.6,16,9,0,7,10,8,0,0,0,0,17163,7.0,17718,229,52,-1063,-1153,22.9,1716.3
4510216676,1,17,1,1,7,5,10,0,0,0,0,17168,7.0,17989,233,52,1089,196,23.3,1716.8,12,6,0,5,7,4,1,1,0,0,16079,6.8,17793,235,52,-1089,-196,23.5,1607.9
4505404755,1,13,1,0,4,4,5,1,1,0,0,15398,6.8,17802,200,60,-893,771,20.0,1539.8,15,2,1,4,4,4,0,0,0,1,16291,6.8,17031,212,36,893,-771,21.2,1629.1
4523881390,1,18,2,1,6,2,8,1,0,1,0,17779,7.6,20127,268,48,3206,2261,26.8,1777.9,15,4,0,2,6,2,0,0,0,0,14573,7.0,17866,225,52,-3206,-2261,22.5,1457.3
4523042890,1,15,3,1,5,6,4,0,0,0,0,17024,7.2,19195,254,63,901,1182,25.4,1702.4,12,2,0,6,5,7,0,0,0,0,16123,6.8,18013,214,48,-901,-1182,21.4,1612.3
4472905174,1,17,3,1,6,3,4,1,1,0,0,16404,7.0,19029,246,43,736,1019,24.6,1640.4,15,3,0,3,6,4,0,0,0,0,15668,6.8,18010,203,73,-736,-1019,20.3,1566.8
4475829266,0,18,4,1,8,6,9,2,1,1,0,18010,7.2,20078,224,66,2120,2095,22.4,1801.0,17,3,0,6,8,5,0,0,0,0,15890,7.0,17983,229,36,-2120,-2095,22.9,1589.0
4520868488,1,15,3,1,9,3,11,0,0,0,0,17592,7.0,18664,220,41,1411,766,22.0,1759.2,11,1,0,3,9,4,1,1,0,0,16181,7.0,17898,215,62,-1411,-766,21.5,1618.1
4506917789,1,12,4,0,4,4,4,1,0,1,0,15607,7.0,18678,215,57,-315,718,21.5,1560.7,18,3,1,4,4,3,1,1,0,0,15922,6.8,17960,246,62,315,-718,24.6,1592.2
4517636777,1,23,6,1,10,6,13,0,0,0,0,18680,7.2,19206,220,61,2013,1022,22.0,1868.0,20,2,0,6,10,8,2,1,1,0,16667,6.8,18184,210,43,-2013,-1022,21.0,1666.7
4469829210,1,34,1,1,9,4,10,2,1,1,0,18303,7.2,19140,263,58,2642,366,26.3,1830.3,16,0,0,4,9,2,0,0,0,0,15661,7.0,18774,231,49,-2642,-366,23.1,1566.1
4521403114,1,15,2,1,7,8,8,1,1,0,0,16142,6.8,17610,197,62,-563,-812,19.7,1614.2,24,4,0,8,7,12,0,0,0,0,16705,7.0,18422,207,48,563,812,20.7,1670.5
4526802557,1,15,4,1,8,9,9,0,0,0,0,17310,7.0,18101,202,45,390,-300,20.2,1731.0,25,0,0,9,8,8,1,1,0,0,16920,7.0,18401,193,46,-390,300,19.3,1692.0
4463256999,1,14,2,1,11,5,11,0,0,0,0,18180,7.0,18464,190,47,2575,1454,19.0,1818.0,33,1,0,5,11,6,1,1,0,0,15605,6.6,17010,203,48,-2575,-1454,20.3,1560.5
4461216989,1,37,4,1,8,4,12,0,0,0,0,18340,7.2,18170,250,56,3206,1437,25.0,1834.0,19,3,0,4,8,7,0,0,0,0,15134,6.6,16733,180,63,-3206,-1437,18.0,1513.4
4508498519,0,23,4,1,5,11,6,1,1,0,0,14998,6.4,15823,199,60,-4011,-3207,19.9,1499.8,18,1,0,11,5,19,0,0,0,0,19009,7.2,19030,233,64,4011,3207,23.3,1900.9
4515404379,0,43,0,0,7,7,6,1,1,0,0,16396,7.0,18419,204,52,-2,866,20.4,1639.6,14,2,1,7,7,5,0,0,0,0,16398,6.8,17553,202,48,2,-866,20.2,1639.8
4500845726,0,18,5,1,4,7,3,2,1,1,0,15420,6.8,17930,235,43,-2264,-1389,23.5,1542.0,18,7,0,7,4,7,0,0,0,0,17684,7.4,19319,237,69,2264,1389,23.7,1768.4
4526466806,1,15,11,1,6,11,8,0,0,0,0,16882,6.8,17922,204,43,-2059,-2345,20.4,1688.2,43,3,0,11,6,14,0,0,0,0,18941,7.4,20267,220,56,2059,2345,22.0,1894.1
4473800740,1,18,17,1,13,5,11,0,0,0,0,20853,7.6,20248,270,43,5501,3548,27.0,2085.3,43,0,0,5,13,7,0,0,0,0,15352,6.8,16700,188,48,-5501,-3548,18.8,1535.2
4518559997,0,17,0,1,4,5,3,2,1,1,0,16018,7.2,18223,215,68,-599,192,21.5,1601.8,17,5,0,5,4,10,0,0,0,0,16617,6.8,18031,242,48,599,-192,24.2,1661.7
4519469738,1,35,3,1,6,2,9,1,1,0,0,16501,6.6,18428,221,44,2761,1659,22.1,1650.1,15,1,0,2,6,1,0,0,0,0,13740,6.6,16769,201,40,-2761,-1659,20.1,1374.0
4503243020,0,17,2,0,3,12,3,0,0,0,0,14232,6.6,16592,216,38,-5617,-4035,21.6,1423.2,15,2,1,12,3,17,1,1,0,0,19849,7.6,20627,238,68,5617,4035,23.8,1984.9
4443967905,0,14,4,0,8,10,6,1,1,0,0,17035,7.0,17308,204,48,-1556,-3181,20.4,1703.5,25,1,1,10,8,9,0,0,0,0,18591,7.4,20489,213,67,1556,3181,21.3,1859.1
4523295777,1,41,3,1,8,7,6,2,1,1,0,17287,7.0,18953,215,62,817,266,21.5,1728.7,18,4,0,7,8,7,0,0,0,0,16470,7.2,18687,218,56,-817,-266,21.8,1647.0
4509440283,1,56,2,1,7,8,7,2,1,1,0,15843,6.8,17154,190,44,-1799,-1304,19.0,1584.3,17,3,0,8,7,15,0,0,0,0,17642,6.8,18458,196,48,1799,1304,19.6,1764.2
4521049898,0,14,0,1,6,9,6,0,0,0,0,15821,6.8,17419,208,43,-3364,-1990,20.8,1582.1,139,2,0,9,6,7,1,0,1,1,19185,7.2,19409,230,49,3364,1990,23.0,1918.5
4452269008,0,11,0,1,7,12,12,0,0,0,0,16880,7.0,17307,216,43,-2125,-3115,21.6,1688.0,14,1,0,12,7,12,1,0,1,0,19005,7.4,20422,221,33,2125,3115,22.1,1900.5
4459259003,1,19,4,1,10,1,7,0,0,0,0,18152,7.2,19147,233,47,4263,2953,23.3,1815.2,16,3,0,1,10,2,1,0,1,0,13889,6.6,16194,204,55,-4263,-2953,20.4,1388.9
4514341381,0,15,0,0,2,10,2,0,0,0,0,13550,6.4,15932,183,30,-4770,-3411,18.3,1355.0,41,1,1,10,2,7,1,1,0,0,18320,7.4,19343,236,56,4770,3411,23.6,1832.0
4499812377,0,21,4,1,5,5,5,1,1,0,0,15371,6.8,16868,224,43,-612,-1300,22.4,1537.1,16,4,0,5,5,7,0,0,0,0,15983,7.2,18168,194,56,612,1300,19.4,1598.3
4495892893,0,16,5,0,5,9,5,1,1,0,1,17087,6.8,17225,206,44,-988,-1321,20.6,1708.7,59,3,1,9,5,8,1,0,1,1,18075,7.2,18546,201,39,988,1321,20.1,1807.5
4516120877,0,41,3,0,3,11,4,1,0,1,0,14423,6.8,16642,190,51,-4452,-3726,19.0,1442.3,15,4,1,11,3,8,1,1,0,0,18875,7.4,20368,238,64,4452,3726,23.8,1887.5
4523420672,0,22,4,1,4,7,6,0,0,0,0,16045,7.0,17984,229,56,-794,-1320,22.9,1604.5,16,2,0,7,4,6,0,0,0,0,16839,7.2,19304,228,56,794,1320,22.8,1683.9
4505177490,1,63,2,0,8,4,11,1,1,0,0,16911,7.2,19106,217,53,2265,2392,21.7,1691.1,33,0,1,4,8,4,0,0,0,0,14646,6.8,16714,178,55,-2265,-2392,17.8,1464.6
4514156871,1,12,2,1,4,4,2,2,1,1,0,15534,7.0,18339,223,64,-483,-442,22.3,1553.4,14,2,0,4,4,5,0,0,0,0,16017,7.2,18781,266,52,483,442,26.6,1601.7
4456066920,1,15,4,0,1,5,0,0,0,0,0,14250,6.8,17406,238,49,-1461,241,23.8,1425.0,20,5,1,5,1,5,2,1,1,0,15711,6.6,17165,228,34,1461,-241,22.8,1571.1
4492401281,0,14,2,1,7,4,5,2,1,1,0,17111,7.0,17761,231,48,1318,764,23.1,1711.1,16,0,0,4,7,4,0,0,0,0,15793,6.8,16997,226,42,-1318,-764,22.6,1579.3
4526793578,0,15,0,1,5,9,4,0,0,0,0,17292,7.0,18087,238,63,-689,-266,23.8,1729.2,11,3,0,9,5,18,1,1,0,0,17981,7.0,18353,214,44,689,266,21.4,1798.1
4526164537,0,17,2,0,4,8,4,0,0,0,0,14434,6.6,15829,183,40,-4603,-2667,18.3,1443.4,17,4,1,8,4,11,2,1,1,1,19037,7.0,18496,212,48,4603,2667,21.2,1903.7
4506087855,0,20,4,0,6,8,5,1,0,1,0,16022,6.8,17899,206,44,-3063,-1676,20.6,1602.2,18,4,1,8,6,12,1,1,0,0,19085,7.2,19575,240,55,3063,1676,24.0,1908.5
4506599171,1,138,2,1,10,6,5,1,1,0,0,16929,7.2,19809,222,51,580,2959,22.2,1692.9,14,1,0,6,10,11,0,0,0,0,16349,6.8,16850,192,43,-580,-2959,19.2,1634.9
4494572826,0,39,4,0,1,5,1,0,0,0,0,13936,6.6,16231,235,45,-2566,-1797,23.5,1393.6,15,2,1,5,1,5,1,1,0,0,16502,7.0,18028,264,51,2566,1797,26.4,1650.2
4496579153,1,16,2,1,8,2,7,1,0,1,0,17755,7.2,19720,228,48,3755,2662,22.8,1775.5,14,1,0,2,8,3,0,0,0,0,14000,6.6,17058,183,51,-3755,-2662,18.3,1400.0
4527078434,0,17,2,1,5,6,10,1,0,1,0,14566,6.4,16031,182,37,-2061,-2046,18.2,1456.6,11,0,0,6,5,7,1,1,0,0,16627,7.0,18077,200,50,2061,2046,20.0,1662.7
4520625705,0,12,0,0,6,9,4,1,0,1,1,16829,6.8,17978,198,48,-489,188,19.8,1682.9,21,0,1,9,6,11,1,1,0,0,17318,6.8,17790,216,47,489,-188,21.6,1731.8
4512335811,1,16,2,1,3,8,4,0,0,0,0,14481,6.4,15768,214,40,-2765,-2274,21.4,1448.1,16,3,0,8,3,16,2,1,1,0,17246,7.2,18042,226,51,2765,2274,22.6,1724.6
4519863035,1,17,2,0,4,5,6,0,0,0,0,15256,6.8,16513,210,41,-957,-2267,21.0,1525.6,21,3,1,5,4,5,1,1,0,0,16213,7.2,18780,235,64,957,2267,23.5,1621.3
4481963149,1,12,2,0,9,2,8,1,1,0,0,17378,7.4,19405,253,44,3268,2650,25.3,1737.8,15,3,1,2,9,3,0,0,0,0,14110,6.4,16755,212,52,-3268,-2650,21.2,1411.0
4450431370,0,14,1,0,7,14,8,0,0,0,0,16336,6.8,16919,190,40,-3908,-2704,19.0,1633.6,17,2,1,14,7,17,1,1,0,0,20244,7.2,19623,208,66,3908,2704,20.8,2024.4
4476985915,0,40,5,0,3,5,4,0,0,0,0,14710,6.8,16797,227,34,-1799,-1942,22.7,1471.0,19,4,1,5,3,8,1,1,0,0,16509,7.0,18739,204,75,1799,1942,20.4,1650.9
4522601125,1,19,1,1,7,3,12,2,1,1,0,17791,7.2,18557,250,48,2763,1017,25.0,1779.1,16,3,0,3,7,5,0,0,0,0,15028,6.8,17540,200,55,-2763,-1017,20.0,1502.8
4479665099,1,16,3,0,5,5,8,0,0,0,0,16871,7.2,18870,227,49,659,-111,22.7,1687.1,12,3,1,5,5,5,1,1,0,0,16212,7.0,18981,238,51,-659,111,23.8,1621.2
4473666102,0,13,3,0,1,10,1,0,0,0,0,13785,6.8,16211,215,43,-4124,-3090,21.5,1378.5,16,3,1,10,1,13,1,1,0,0,17909,7.2,19301,260,54,4124,3090,26.0,1790.9
4480049039,0,14,3,0,6,7,8,1,1,0,0,15390,6.8,17104,194,47,-1423,-1150,19.4,1539.0,19,0,1,7,6,3,0,0,0,0,16813,7.2,18254,218,56,1423,1150,21.8,1681.3
4524773384,1,18,0,0,7,7,10,1,1,0,0,16585,6.8,16982,191,42,-536,-864,19.1,1658.5,17,1,1,7,7,9,0,0,0,0,17121,6.8,17846,234,52,536,864,23.4,1712.1
4525998328,0,18,1,0,3,5,2,0,0,0,0,14442,6.8,16949,209,47,-2402,-1269,20.9,1444.2,17,5,1,5,3,7,2,1,1,0,16844,7.0,18218,240,60,2402,1269,24.0,1684.4
4419100258,0,15,1,0,3,5,3,0,0,0,0,15820,6.8,17793,220,55,-306,-282,22.0,1582.0,17,4,1,5,3,8,2,1,1,0,16126,7.0,18075,222,52,306,282,22.2,1612.6
4524528416,1,14,3,0,4,3,1,1,1,0,0,15195,7.0,18358,217,70,324,1794,21.7,1519.5,16,1,1,3,4,2,0,0,0,0,14871,6.4,16564,228,35,-324,-1794,22.8,1487.1
4523992851,0,15,1,1,4,6,4,0,0,0,0,15865,7.0,18437,238,59,-418,34,23.8,1586.5,15,2,0,6,4,8,1,1,0,0,16283,7.0,18403,231,52,418,-34,23.1,1628.3
4472174741,0,13,5,0,4,9,4,0,0,0,0,15102,6.8,17421,214,56,-2173,-2274,21.4,1510.2,16,7,1,9,4,9,1,1,0,0,17275,7.4,19695,212,59,2173,2274,21.2,1727.5
4468744263,0,22,4,0,7,6,11,0,0,0,0,16587,6.8,17801,216,44,-674,909,21.6,1658.7,20,6,1,6,7,8,0,0,0,0,17261,6.6,16892,219,34,674,-909,21.9,1726.1
4509809215,1,14,1,1,7,6,11,0,0,0,0,18027,7.0,17905,217,59,2394,873,21.7,1802.7,142,3,0,6,7,5,1,1,0,0,15633,6.8,17032,219,53,-2394,-873,21.9,1563.3
4507384593,1,17,3,1,8,7,15,0,0,0,0,17885,6.8,17553,216,47,2071,1096,21.6,1788.5,28,3,0,7,8,10,1,1,0,0,15814,6.6,16457,188,36,-2071,-1096,18.8,1581.4
4477499518,1,23,3,1,12,8,10,0,0,0,0,17668,6.8,17036,184,40,-120,-393,18.4,1766.8,15,3,0,8,12,8,0,0,0,0,17788,6.8,17429,194,36,120,393,19.4,1778.8
4450382199,0,18,2,1,7,8,7,0,0,0,1,18000,6.8,17798,210,48,1157,-173,21.0,1800.0,56,5,0,8,7,10,0,0,0,0,16843,7.0,17971,190,53,-1157,173,19.0,1684.3
4524951656,0,14,2,0,4,15,5,0,0,0,0,15316,6.6,15976,184,44,-2883,-3312,18.4,1531.6,18,3,1,15,4,15,1,1,0,0,18199,7.2,19288,194,48,2883,3312,19.4,1819.9
4521693462,0,13,0,0,1,8,1,0,0,0,0,13141,6.6,16162,202,39,-4046,-2777,20.2,1314.1,13,0,1,8,1,5,1,0,1,0,17187,7.2,18939,214,52,4046,2777,21.4,1718.7
4517513355,1,17,4,1,9,6,7,0,0,0,0,17147,7.2,19004,197,52,1412,1897,19.7,1714.7,18,2,0,6,9,4,1,1,0,0,15735,6.8,17107,210,43,-1412,-1897,21.0,1573.5
4499681914,0,15,1,1,1,13,1,0,0,0,0,12622,5.8,13759,185,32,-6954,-5631,18.5,1262.2,17,4,0,13,1,16,2,1,1,0,19576,7.4,19390,228,44,6954,5631,22.8,1957.6
4523821481,1,15,6,1,14,3,17,1,1,0,0,20005,7.4,20561,222,68,5201,4398,22.2,2000.5,71,1,0,3,14,3,0,0,0,0,14804,6.6,16163,211,44,-5201,-4398,21.1,1480.4
4466193418,0,15,13,0,5,5,7,1,0,1,0,16686,7.4,19183,240,55,-418,60,24.0,1668.6,43,2,1,5,5,3,1,1,0,0,17104,7.2,19123,273,58,418,-60,27.3,1710.4
4475955014,1,18,1,0,8,5,8,1,1,0,0,16469,7.0,18105,192,46,248,582,19.2,1646.9,15,2,1,5,8,10,0,0,0,0,16221,6.6,17523,225,52,-248,-582,22.5,1622.1
4515536584,0,16,3,1,4,4,4,1,0,1,0,15420,6.6,16188,185,61,-634,-1526,18.5,1542.0,21,3,0,4,4,4,1,1,0,0,16054,6.8,17714,236,52,634,1526,23.6,1605.4
4480526985,1,17,2,1,6,3,6,0,0,0,0,17186,7.0,18505,234,68,2320,2234,23.4,1718.6,17,2,0,3,6,6,0,0,0,0,14866,6.6,16271,207,44,-2320,-2234,20.7,1486.6
4436976598,1,13,2,1,13,6,11,0,0,0,0,18896,7.4,19340,198,55,2663,1537,19.8,1889.6,19,1,0,6,13,5,1,1,0,0,16233,6.8,17803,201,52,-2663,-1537,20.1,1623.3
4458619259,0,16,3,0,3,9,2,0,0,0,0,14861,6.8,16993,225,38,-3337,-1701,22.5,1486.1,30,3,1,9,3,10,0,0,0,0,18198,7.2,18694,223,51,3337,1701,22.3,1819.8
4472127504,0,20,1,1,8,8,10,2,1,1,0,16906,6.8,17910,207,48,226,221,20.7,1690.6,15,3,0,8,8,4,0,0,0,0,16680,6.8,17689,176,54,-226,-221,17.6,1668.0
4468947344,1,19,3,1,3,5,2,1,1,0,0,15530,6.8,17181,221,60,196,-183,22.1,1553.0,29,2,0,5,3,4,1,0,1,0,15334,7.0,17364,202,52,-196,183,20.2,1533.4
4478911331,1,14,4,0,12,5,23,1,1,0,0,18494,6.8,17736,212,43,3098,2685,21.2,1849.4,25,1,1,5,12,9,0,0,0,0,15396,6.2,15051,188,34,-3098,-2685,18.8,1539.6
4500426573,0,17,3,0,3,8,3,0,0,0,0,15015,6.8,17386,216,60,-2327,-2301,21.6,1501.5,75,3,1,8,3,8,1,0,1,0,17342,7.2,19687,230,52,2327,2301,23.0,1734.2
4456615224,0,16,3,0,3,5,2,0,0,0,0,15631,7.2,18436,252,53,-704,-1028,25.2,1563.1,16,1,1,5,3,4,1,1,0,0,16335,7.4,19464,229,72,704,1028,22.9,1633.5
4499426958,0,16,2,1,5,7,4,0,0,0,0,15538,6.8,16787,207,46,-707,-1088,20.7,1553.8,41,2,0,7,5,11,0,0,0,0,16245,6.8,17875,208,41,707,1088,20.8,1624.5
4514283603,1,17,1,1,6,8,4,1,1,0,0,16021,6.8,18021,199,48,-620,-384,19.9,1602.1,14,5,0,8,6,9,0,0,0,0,16641,7.2,18405,217,44,620,384,21.7,1664.1
4491168583,1,51,4,0,7,5,14,1,1,0,0,17075,7.0,18159,230,52,462,579,23.0,1707.5,17,4,1,5,7,6,0,0,0,0,16613,6.6,17580,224,51,-462,-579,22.4,1661.3
4526044508,1,19,3,0,6,6,7,0,0,0,0,16302,7.0,18040,212,45,95,772,21.2,1630.2,15,6,1,6,6,7,1,1,0,0,16207,6.8,17268,205,46,-95,-772,20.5,1620.7
4516849769,0,13,2,1,5,12,5,0,0,0,0,15230,6.4,15161,185,44,-3832,-3915,18.5,1523.0,16,0,0,12,5,11,1,1,0,0,19062,7.4,19076,219,58,3832,3915,21.9,1906.2
4513070256,0,84,3,0,5,12,4,0,0,0,0,15819,7.0,18015,199,54,-3176,-2235,19.9,1581.9,14,2,1,12,5,17,1,1,0,0,18995,7.6,20250,222,50,3176,2235,22.2,1899.5
4527522353,1,17,7,0,10,7,9,1,1,0,0,17712,7.0,19043,207,42,2370,3795,20.7,1771.2,18,3,1,7,10,6,0,0,0,0,15342,6.4,15248,186,38,-2370,-3795,18.6,1534.2
4519991680,0,16,3,1,6,10,3,0,0,0,0,14812,6.8,17359,183,36,-2393,-881,18.3,1481.2,16,0,0,10,6,8,0,0,0,0,17205,7.0,18240,214,43,2393,881,21.4,1720.5
4526865205,1,19,3,1,4,5,2,0,0,0,0,15538,6.8,18054,223,57,-450,-849,22.3,1553.8,33,3,0,5,4,6,0,0,0,0,15988,7.2,18903,189,56,450,849,18.9,1598.8
4492936245,0,40,3,0,1,7,1,0,0,0,0,13325,6.6,16064,171,52,-3573,-2497,17.1,1332.5,18,3,1,7,1,12,2,1,1,0,16898,7.2,18561,230,51,3573,2497,23.0,1689.8
4524090743,0,14,4,0,4,8,3,1,0,1,0,15484,7.2,18316,226,50,-2528,-882,22.6,1548.4,42,1,1,8,4,11,1,1,0,0,18012,7.2,19198,236,56,2528,882,23.6,1801.2
4501451685,1,14,4,0,5,8,7,2,1,1,0,16256,7.0,17637,231,56,-1623,-1144,23.1,1625.6,14,0,1,8,5,9,0,0,0,0,17879,7.0,18781,243,48,1623,1144,24.3,1787.9
4521689217,0,16,2,0,3,7,2,1,1,0,0,15252,7.0,18024,224,56,-1293,-380,22.4,1525.2,38,3,1,7,3,8,0,0,0,0,16545,7.0,18404,219,48,1293,380,21.9,1654.5
4452577229,1,16,4,1,10,8,8,0,0,0,0,18602,7.4,20068,200,64,123,1313,20.0,1860.2,29,3,0,8,10,6,1,0,1,1,18479,7.2,18755,226,46,-123,-1313,22.6,1847.9
4526421447,0,23,1,0,6,8,3,0,0,0,0,16365,6.8,18280,195,71,94,1896,19.5,1636.5,18,3,1,8,6,8,1,1,0,0,16271,6.6,16384,191,50,-94,-1896,19.1,1627.1
4468449125,1,17,3,1,7,6,10,1,1,0,0,17097,7.2,18614,220,71,620,-328,22.0,1709.7,14,2,0,6,7,4,0,0,0,0,16477,7.2,18942,207,52,-620,328,20.7,1647.7
4523054451,1,12,1,1,5,4,3,1,1,0,0,15015,6.4,16819,184,47,-585,-809,18.4,1501.5,17,2,0,4,5,2,1,0,1,0,15600,6.8,17628,248,52,585,809,24.8,1560.0
4490273842,1,17,3,1,6,4,5,2,1,1,0,16727,7.2,18834,220,55,613,-602,22.0,1672.7,40,3,0,4,6,3,0,0,0,0,16114,7.4,19436,247,52,-613,602,24.7,1611.4
4505912615,1,19,2,1,6,0,9,0,0,0,0,18307,7.4,19628,235,69,5027,3394,23.5,1830.7,56,3,0,0,6,0,0,0,0,0,13280,6.4,16234,211,53,-5027,-3394,21.1,1328.0
4527268691,0,17,2,1,13,8,12,0,0,0,0,18116,6.8,18447,187,40,838,914,18.7,1811.6,36,1,0,8,13,9,2,1,1,0,17278,7.2,17533,204,44,-838,-914,20.4,1727.8
4516433412,0,81,0,1,3,2,3,1,0,1,0,15716,7.2,19033,251,56,121,264,25.1,1571.6,15,2,0,2,3,1,1,1,0,0,15595,7.0,18769,255,76,-121,-264,25.5,1559.5
4486112923,0,15,2,0,2,7,2,1,0,1,0,14864,6.6,16742,249,41,-2219,-1498,24.9,1486.4,19,3,1,7,2,15,1,1,0,0,17083,7.0,18240,229,52,2219,1498,22.9,1708.3
4465024701,0,22,3,0,7,7,6,1,1,0,0,17597,7.2,18452,244,36,118,299,24.4,1759.7,14,3,1,7,7,7,0,0,0,0,17479,7.0,18153,224,62,-118,-299,22.4,1747.9
4519429379,1,37,3,1,6,4,5,0,0,0,0,17180,7.0,19599,258,64,1748,1496,25.8,1718.0,11,2,0,4,6,1,1,1,0,0,15432,7.0,18103,236,50,-1748,-1496,23.6,1543.2
4509170584,0,17,4,0,4,3,6,0,0,0,0,14353,6.8,17197,178,48,-1009,-280,17.8,1435.3,17,4,1,3,4,1,1,1,0,0,15362,6.8,17477,222,62,1009,280,22.2,1536.2
4513970902,1,22,3,1,8,6,7,0,0,0,0,18273,7.0,18951,211,49,2879,2522,21.1,1827.3,13,5,0,6,8,7,0,0,0,0,15394,6.4,16429,195,32,-2879,-2522,19.5,1539.4
4495742635,1,14,3,1,14,6,17,1,1,0,0,20177,7.8,21248,236,56,3696,3558,23.6,2017.7,7,3,0,6,14,5,0,0,0,0,16481,7.0,17690,207,47,-3696,-3558,20.7,1648.1
4527443985,1,18,0,1,9,2,6,0,0,0,0,17947,7.2,19669,239,36,4121,3050,23.9,1794.7,50,1,0,2,9,1,0,0,0,0,13826,6.8,16619,177,62,-4121,-3050,17.7,1382.6
4502587670,0,17,4,0,5,7,6,0,0,0,0,15639,6.6,16156,196,48,-1003,-1777,19.6,1563.9,17,3,1,7,5,7,1,1,0,0,16642,6.8,17933,204,48,1003,1777,20.4,1664.2
4525953219,0,19,1,1,7,7,6,1,1,0,0,15990,6.8,17803,190,50,-1425,-1068,19.0,1599.0,9,2,0,7,7,6,0,0,0,0,17415,7.2,18871,241,41,1425,1068,24.1,1741.5
4517748095,0,14,1,0,5,14,6,2,1,1,0,15015,6.6,16032,167,54,-5065,-3552,16.7,1501.5,16,1,1,14,5,9,0,0,0,0,20080,7.4,19584,224,52,5065,3552,22.4,2008.0
4453712057,0,16,4,1,6,6,5,1,0,1,0,17783,7.6,19374,236,72,1498,149,23.6,1778.3,13,3,0,6,6,7,1,1,0,0,16285,7.4,19225,213,61,-1498,-149,21.3,1628.5
4524407688,1,18,1,1,2,1,2,1,1,0,0,15649,7.0,18530,269,56,1281,1111,26.9,1564.9,13,2,0,1,2,0,0,0,0,0,14368,7.0,17419,225,62,-1281,-1111,22.5,1436.8
4484464676,0,45,5,0,3,4,3,0,0,0,0,15128,6.8,18400,215,54,-279,577,21.5,1512.8,17,3,1,4,3,5,1,1,0,0,15407,7.0,17823,244,48,279,-577,24.4,1540.7
4471057382,0,18,1,0,3,9,3,0,0,0,0,13705,6.4,16018,184,40,-4651,-3870,18.4,1370.5,14,3,1,9,3,8,1,1,0,0,18356,7.2,19888,223,71,4651,3870,22.3,1835.6
4518369652,1,16,6,1,7,5,6,1,0,1,0,16887,7.0,18500,212,39,1564,1214,21.2,1688.7,63,4,0,5,7,5,1,1,0,0,15323,6.6,17286,200,47,-1564,-1214,20.0,1532.3
4420829528,1,20,7,0,11,4,12,0,0,0,0,19392,7.2,18570,239,48,4872,3076,23.9,1939.2,20,3,1,4,11,6,0,0,0,0,14520,6.2,15494,203,34,-4872,-3076,20.3,1452.0
4492525886,0,13,1,0,3,6,1,0,0,0,0,14423,6.6,16966,219,48,-2602,-1426,21.9,1442.3,15,4,1,6,3,6,0,0,0,0,17025,7.2,18392,249,54,2602,1426,24.9,1702.5
4502743834,0,25,4,1,4,8,8,1,0,1,0,15167,6.4,15683,220,37,-1645,-1268,22.0,1516.7,16,6,0,8,4,17,0,0,0,0,16812,6.4,16951,198,44,1645,1268,19.8,1681.2
4460355612,0,33,1,0,10,7,11,1,0,1,1,19186,7.2,18375,183,51,1377,795,18.3,1918.6,14,2,1,7,10,8,1,1,0,0,17809,7.0,17580,201,52,-1377,-795,20.1,1780.9
4508177030,1,42,2,0,4,6,2,1,1,0,0,15272,7.0,18442,205,47,-716,573,20.5,1527.2,145,3,1,6,4,5,0,0,0,0,15988,6.8,17869,207,50,716,-573,20.7,1598.8
4456176215,0,21,1,0,3,7,2,1,1,0,0,14505,6.8,17362,216,52,-4531,-2325,21.6,1450.5,14,1,1,7,3,8,1,0,1,1,19036,7.2,19687,252,58,4531,2325,25.2,1903.6
4491793322,0,14,2,0,0,11,0,1,0,1,0,13475,6.2,15686,206,71,-5840,-2412,20.6,1347.5,16,6,1,11,0,16,1,1,0,0,19315,7.0,18098,262,49,5840,2412,26.2,1931.5
4526009569,0,37,2,0,1,9,3,0,0,0,0,13719,6.4,16024,202,43,-4492,-4085,20.2,1371.9,16,3,1,9,1,8,0,0,0,0,18211,7.6,20109,219,75,4492,4085,21.9,1821.1
4477684980,1,18,5,1,6,8,6,0,0,0,0,17210,7.0,18131,220,72,1091,605,22.0,1721.0,51,3,0,8,6,10,0,0,0,0,16119,7.0,17526,178,32,-1091,-605,17.8,1611.9
4521949679,0,14,2,1,6,7,8,1,1,0,0,15307,6.4,15025,175,48,-660,-922,17.5,1530.7,44,1,0,7,6,12,0,0,0,0,15967,6.4,15947,171,37,660,922,17.1,1596.7
4514071420,1,13,3,1,12,8,18,1,1,0,0,18047,7.0,18071,202,44,679,-305,20.2,1804.7,12,4,0,8,12,7,1,0,1,0,17368,7.0,18376,206,44,-679,305,20.6,1736.8
4517836612,1,14,4,1,8,5,8,1,1,0,0,18021,7.2,19358,253,52,1790,1764,25.3,1802.1,25,1,0,5,8,4,0,0,0,0,16231,7.0,17594,237,47,-1790,-1764,23.7,1623.1
4507103661,1,13,1,1,8,7,6,1,0,1,1,18271,6.8,18004,223,46,1656,95,22.3,1827.1,13,0,0,7,8,6,1,1,0,0,16615,7.0,17909,226,54,-1656,-95,22.6,1661.5
4492694297,1,15,0,1,11,6,9,1,1,0,0,17229,7.0,18401,191,40,354,736,19.1,1722.9,28,4,0,6,11,6,0,0,0,0,16875,6.8,17665,202,52,-354,-736,20.2,1687.5
4489456327,0,42,3,0,8,7,13,1,1,0,0,17909,6.4,16512,165,39,1340,-207,16.5,1790.9,19,4,1,7,8,10,0,0,0,0,16569,6.6,16719,201,32,-1340,207,20.1,1656.9
4523806048,0,16,2,1,5,3,6,1,1,0,0,15946,7.0,18587,223,51,1433,1278,22.3,1594.6,46,4,0,3,5,2,0,0,0,0,14513,7.0,17309,183,54,-1433,-1278,18.3,1451.3
4516554886,0,10,8,0,3,6,2,0,0,0,0,14998,7.0,17859,218,60,-993,-1150,21.8,1499.8,39,3,1,6,3,6,1,1,0,0,15991,7.0,19009,236,55,993,1150,23.6,1599.1
4524615195,1,12,2,0,10,8,9,2,1,1,0,19862,7.8,20693,252,64,2228,1524,25.2,1986.2,15,0,1,8,10,8,0,0,0,0,17634,7.2,19169,228,57,-2228,-1524,22.8,1763.4
4525291177,0,73,3,1,9,13,15,0,0,0,0,16300,5.8,13423,141,29,-3173,-4350,14.1,1630.0,14,2,0,13,9,18,1,1,0,0,19473,7.0,17773,207,46,3173,4350,20.7,1947.3
4490153462,1,12,0,0,5,6,8,1,1,0,0,16891,6.8,18030,185,48,286,17,18.5,1689.1,44,4,1,6,5,12,0,0,0,0,16605,6.8,18013,214,47,-286,-17,21.4,1660.5
4513785309,0,16,4,0,3,10,3,0,0,0,0,14536,6.6,15452,201,44,-3203,-2199,20.1,1453.6,18,4,1,10,3,8,0,0,0,0,17739,7.2,17651,212,36,3203,2199,21.2,1773.9
4526866944,0,17,3,1,7,4,12,1,1,0,0,17199,7.0,19299,229,59,1545,1417,22.9,1719.9,16,2,0,4,7,5,0,0,0,0,15654,7.2,17882,226,53,-1545,-1417,22.6,1565.4
4524877536,1,13,4,0,7,8,6,1,1,0,0,17002,7.0,17795,221,51,-154,-612,22.1,1700.2,19,4,1,8,7,4,1,0,1,0,17156,7.0,18407,225,48,154,612,22.5,1715.6
4520523189,1,26,5,1,5,3,5,1,1,0,0,15582,7.0,18842,234,55,-18,788,23.4,1558.2,37,2,0,3,5,7,0,0,0,0,15600,7.0,18054,202,67,18,-788,20.2,1560.0
4519982625,0,16,1,1,4,6,2,0,0,0,0,15416,7.2,18403,214,51,-2219,-677,21.4,1541.6,15,3,0,6,4,7,2,1,1,0,17635,7.2,19080,237,56,2219,677,23.7,1763.5
4495903813,1,12,2,0,6,2,9,1,1,0,0,16405,7.2,18231,233,47,1410,1243,23.3,1640.5,12,2,1,2,6,3,0,0,0,0,14995,6.6,16988,235,52,-1410,-1243,23.5,1499.5
4522349716,0,13,2,0,6,11,6,1,1,0,0,16543,7.0,17893,213,47,-3032,-1002,21.3,1654.3,16,2,1,11,6,16,0,0,0,0,19575,7.2,18895,240,39,3032,1002,24.0,1957.5
4527087775,1,16,3,1,10,5,13,1,0,1,0,18868,7.2,19111,259,44,2461,956,25.9,1886.8,17,4,0,5,10,5,1,1,0,0,16407,6.8,18155,237,52,-2461,-956,23.7,1640.7
4519552784,0,21,4,1,11,9,10,1,1,0,0,18172,6.8,17184,191,36,1390,437,19.1,1817.2,15,1,0,9,11,7,0,0,0,0,16782,6.6,16747,181,30,-1390,-437,18.1,1678.2
4524327775,1,23,2,1,6,3,8,0,0,0,0,16050,7.0,17867,195,44,2041,1289,19.5,1605.0,37,2,0,3,6,1,0,0,0,0,14009,6.4,16578,202,44,-2041,-1289,20.2,1400.9
4502866090,1,18,2,1,7,1,9,1,0,1,1,18764,7.0,18764,268,51,5121,2946,26.8,1876.4,36,3,0,1,7,2,0,0,0,0,13643,6.4,15818,201,54,-5121,-2946,20.1,1364.3
4526085370,1,21,5,1,12,6,8,1,1,0,0,18432,7.2,19560,224,41,2495,3183,22.4,1843.2,19,2,0,6,12,8,0,0,0,0,15937,6.8,16377,193,52,-2495,-3183,19.3,1593.7
4473499451,1,18,5,1,9,4,10,0,0,0,0,18307,7.2,19026,244,49,3113,2284,24.4,1830.7,17,5,0,4,9,3,1,1,0,0,15194,6.4,16742,213,48,-3113,-2284,21.3,1519.4
4499919097,1,17,3,0,7,2,9,0,0,0,0,16454,7.0,18576,207,45,2042,1127,20.7,1645.4,15,2,1,2,7,1,0,0,0,0,14412,6.8,17449,195,72,-2042,-1127,19.5,1441.2
4474087282,1,41,3,0,6,4,5,0,0,0,0,15724,6.8,17512,217,46,81,1865,21.7,1572.4,21,3,1,4,6,7,1,1,0,0,15643,6.4,15647,219,58,-81,-1865,21.9,1564.3
4523940286,0,18,2,0,5,6,8,2,1,1,0,16315,6.8,17744,236,56,199,403,23.6,1631.5,17,2,1,6,5,9,0,0,0,0,16116,6.6,17341,227,34,-199,-403,22.7,1611.6
4524699601,1,15,4,0,8,5,7,0,0,0,0,16239,6.8,17856,200,48,36,1099,20.0,1623.9,15,3,1,5,8,6,0,0,0,0,16203,6.6,16757,215,44,-36,-1099,21.5,1620.3
4512078045,0,36,4,0,5,5,5,1,0,1,0,15963,7.2,18713,218,62,-985,-93,21.8,1596.3,22,2,1,5,5,5,1,1,0,0,16948,7.2,18806,262,61,985,93,26.2,1694.8
4518554441,0,17,2,0,5,11,3,1,1,0,0,14801,6.2,16202,209,42,-3527,-1901,20.9,1480.1,19,3,1,11,5,12,0,0,0,0,18328,7.0,18103,230,43,3527,1901,23.0,1832.8
4448427323,0,14,1,1,15,3,5,0,0,0,0,19038,7.2,19801,261,32,4941,4702,26.1,1903.8,17,2,0,3,15,5,0,0,0,0,14097,6.2,15099,190,48,-4941,-4702,19.0,1409.7
4477447831,1,19,4,0,6,5,8,1,1,0,0,15416,6.8,17061,199,55,-1342,-713,19.9,1541.6,34,4,1,5,6,7,0,0,0,0,16758,6.8,17774,248,50,1342,713,24.8,1675.8
4445248435,0,32,3,0,5,8,3,1,1,0,0,14795,6.6,16454,178,52,-2914,-2683,17.8,1479.5,19,3,1,8,5,11,1,0,1,0,17709,7.2,19137,229,52,2914,2683,22.9,1770.9
4519467350,0,14,1,0,6,7,10,2,1,1,0,15931,7.0,17903,202,48,-1613,-836,20.2,1593.1,17,1,1,7,6,10,0,0,0,0,17544,7.2,18739,217,58,1613,836,21.7,1754.4
4527621723,1,46,0,1,10,2,7,2,1,1,3,19557,7.0,18070,191,51,4380,3242,19.1,1955.7,9,2,0,2,10,4,0,0,0,1,15177,6.0,14828,184,49,-4380,-3242,18.4,1517.7
4499944333,0,11,1,1,3,9,3,0,0,0,0,14291,6.4,15475,212,48,-4991,-3526,21.2,1429.1,17,0,0,9,3,13,2,1,1,1,19282,7.2,19001,216,53,4991,3526,21.6,1928.2
4522462611,0,16,2,1,7,7,13,1,1,0,0,16034,6.6,16642,199,40,-754,-729,19.9,1603.4,14,1,0,7,7,12,0,0,0,0,16788,6.8,17371,224,50,754,729,22.4,1678.8
4511135816,0,12,3,0,5,5,4,0,0,0,0,16840,7.2,19282,264,53,-103,859,26.4,1684.0,17,2,1,5,5,3,2,1,1,1,16943,7.0,18423,219,48,103,-859,21.9,1694.3
4481977173,0,11,5,1,6,9,8,0,0,0,0,17025,7.0,18038,231,40,-1314,-1942,23.1,1702.5,17,2,0,9,6,9,1,1,0,0,18339,7.4,19980,232,57,1314,1942,23.2,1833.9
4482569036,0,24,0,1,4,7,5,0,0,0,0,15267,6.8,17008,212,52,-1002,-2319,21.2,1526.7,12,3,0,7,4,9,1,0,1,0,16269,7.0,19327,209,60,1002,2319,20.9,1626.9
4527301356,0,13,2,0,10,10,8,1,0,1,0,18524,7.0,18597,194,58,85,1243,19.4,1852.4,18,3,1,10,10,14,1,1,0,0,18439,6.6,17354,182,47,-85,-1243,18.2,1843.9
4514381198,1,183,2,0,8,11,8,0,0,0,0,16900,6.8,17296,168,52,-590,527,16.8,1690.0,10,0,1,11,8,10,0,0,0,0,17490,6.4,16769,186,48,590,-527,18.6,1749.0
4526331089,0,14,3,0,5,6,3,1,1,0,0,15367,7.2,18799,217,56,-2021,-768,21.7,1536.7,16,4,1,6,5,7,0,0,0,0,17388,7.4,19567,238,68,2021,768,23.8,1738.8
4483650027,0,17,3,0,1,6,1,0,0,0,0,14325,6.8,17432,235,57,-1887,-587,23.5,1432.5,17,4,1,6,1,10,1,1,0,0,16212,7.2,18019,228,52,1887,587,22.8,1621.2
4497717401,0,14,1,0,5,8,3,0,0,0,0,16367,7.2,18191,254,48,-1204,-717,25.4,1636.7,42,3,1,8,5,8,1,1,0,0,17571,7.0,18908,218,56,1204,717,21.8,1757.1
4474588712,0,14,4,1,9,4,8,0,0,0,0,18471,7.4,19497,225,65,3252,2304,22.5,1847.1,15,3,0,4,9,3,1,1,0,0,15219,6.8,17193,201,62,-3252,-2304,20.1,1521.9
4511697354,1,16,3,1,11,6,17,0,0,0,0,17895,6.8,16640,191,38,2088,-118,19.1,1789.5,16,3,0,6,11,5,1,1,0,0,15807,6.6,16758,202,41,-2088,118,20.2,1580.7
4525324183,0,15,3,0,6,5,9,1,1,0,0,15368,6.4,16039,169,55,71,-679,16.9,1536.8,16,2,1,5,6,2,0,0,0,0,15297,6.4,16718,198,51,-71,679,19.8,1529.7
4494944051,0,13,5,1,3,7,4,0,0,0,0,15392,6.8,17234,240,44,-1445,-694,24.0,1539.2,15,3,0,7,3,9,0,0,0,0,16837,6.8,17928,225,50,1445,694,22.5,1683.7
4508869130,0,15,1,0,8,8,5,0,0,0,0,17188,6.6,17474,229,35,809,645,22.9,1718.8,11,1,1,8,8,10,1,0,1,0,16379,6.6,16829,191,47,-809,-645,19.1,1637.9
4516990759,1,57,5,1,6,4,3,0,0,0,0,16601,7.0,18618,242,52,1235,1010,24.2,1660.1,15,3,0,4,6,5,0,0,0,0,15366,6.8,17608,201,44,-1235,-1010,20.1,1536.6
4521752962,1,29,3,1,7,5,5,2,1,1,0,16426,7.0,18407,222,55,-108,59,22.2,1642.6,14,4,0,5,7,4,0,0,0,0,16534,6.8,18348,247,44,108,-59,24.7,1653.4
4524676649,1,14,2,1,9,3,11,1,1,0,0,18519,7.2,18891,260,49,4756,3562,26.0,1851.9,16,2,0,3,9,3,0,0,0,0,13763,6.4,15329,196,24,-4756,-3562,19.6,1376.3
4481753075,1,16,3,0,4,5,5,0,0,0,0,15375,6.8,17114,200,56,-1270,-2363,20.0,1537.5,17,0,1,5,4,1,1,1,0,0,16645,7.2,19477,273,60,1270,2363,27.3,1664.5
4509570260,0,19,4,0,1,6,1,0,0,0,0,15459,7.0,18187,243,71,-2483,-1894,24.3,1545.9,18,5,1,6,1,7,2,1,1,0,17942,7.4,20081,254,72,2483,1894,25.4,1794.2
4494926014,0,16,1,0,3,8,3,0,0,0,0,14397,6.6,16267,210,52,-3517,-3374,21.0,1439.7,14,2,1,8,3,9,1,1,0,0,17914,7.2,19641,226,64,3517,3374,22.6,1791.4
4515598035,1,18,6,1,4,4,7,1,1,0,0,15550,7.0,18512,221,64,-44,73,22.1,1555.0,41,4,0,4,4,5,0,0,0,0,15594,7.0,18439,216,48,44,-73,21.6,1559.4
4467297984,1,13,2,1,8,10,5,1,1,0,0,17136,6.8,18329,224,60,-506,-700,22.4,1713.6,14,3,0,10,8,7,0,0,0,0,17642,7.2,19029,218,34,506,700,21.8,1764.2
4519835151,0,19,3,0,6,9,3,0,0,0,0,16404,6.8,18053,231,40,-554,174,23.1,1640.4,17,4,1,9,6,9,2,1,1,0,16958,6.8,17879,204,41,554,-174,20.4,1695.8
4521454203,0,54,4,0,3,5,5,0,0,0,0,15238,6.8,16831,209,40,-1314,-1498,20.9,1523.8,17,1,1,5,3,6,0,0,0,0,16552,6.8,18329,226,63,1314,1498,22.6,1655.2
4527898486,1,57,3,1,5,4,5,1,1,0,0,15965,7.0,18534,208,52,725,1773,20.8,1596.5,16,3,0,4,5,5,1,0,1,0,15240,6.8,16761,202,40,-725,-1773,20.2,1524.0
4520667949,1,13,1,1,14,3,8,1,1,0,0,19085,7.2,19432,226,40,4784,3335,22.6,1908.5,14,1,0,3,14,2,0,0,0,0,14301,6.2,16097,178,47,-4784,-3335,17.8,1430.1
4456434155,1,21,1,1,11,7,15,0,0,0,0,17446,7.0,18714,186,49,900,1093,18.6,1744.6,14,1,0,7,11,8,1,1,0,0,16546,6.8,17621,220,58,-900,-1093,22.0,1654.6
4506295504,0,13,2,0,3,6,1,1,1,0,0,14411,6.8,16806,210,54,-1864,-1945,21.0,1441.1,19,0,1,6,3,6,1,0,1,0,16275,7.2,18751,198,66,1864,1945,19.8,1627.5
4523041821,1,17,4,0,5,5,3,2,1,1,0,16344,7.2,19071,227,64,1168,2292,22.7,1634.4,17,2,1,5,5,3,0,0,0,0,15176,6.8,16779,206,38,-1168,-2292,20.6,1517.6
4495119818,1,18,1,1,4,4,9,1,0,1,0,15405,6.8,17336,215,57,-601,-1965,21.5,1540.5,16,1,0,4,4,5,1,1,0,0,16006,7.2,19301,249,71,601,1965,24.9,1600.6
4526301397,0,10,1,0,3,11,4,0,0,0,0,15145,6.6,16768,200,32,-3472,-3059,20.0,1514.5,102,0,1,11,3,6,1,0,1,0,18617,7.4,19827,227,63,3472,3059,22.7,1861.7
4488789257,0,18,2,1,5,7,8,0,0,0,0,15885,6.6,16848,220,43,-1566,-2539,22.0,1588.5,17,5,0,7,5,7,1,1,0,0,17451,7.2,19387,221,80,1566,2539,22.1,1745.1
4521058802,1,17,4,1,7,2,8,0,0,0,0,16830,7.2,18443,232,54,2431,1886,23.2,1683.0,31,1,0,2,7,2,0,0,0,0,14399,6.6,16557,209,48,-2431,-1886,20.9,1439.9
4477297316,1,16,2,1,4,3,3,1,0,1,2,17048,6.6,17678,206,48,2575,997,20.6,1704.8,14,3,0,3,4,4,1,1,0,0,14473,6.8,16681,214,43,-2575,-997,21.4,1447.3
4503847672,0,18,1,0,5,2,5,1,1,0,0,15950,7.0,18633,247,44,1233,251,24.7,1595.0,14,2,1,2,5,2,0,0,0,0,14717,6.8,18382,204,60,-1233,-251,20.4,1471.7
4465964389,0,36,6,0,4,8,7,0,0,0,0,14795,6.6,16491,190,36,-3431,-1020,19.0,1479.5,27,1,1,8,4,11,1,1,0,0,18226,6.8,17511,221,47,3431,1020,22.1,1822.6
4488956857,0,14,2,1,5,8,5,1,1,0,0,15786,6.6,16737,219,44,-1860,-2194,21.9,1578.6,12,2,0,8,5,11,1,0,1,0,17646,7.2,18931,231,44,1860,2194,23.1,1764.6
4518416008,1,19,2,0,5,9,6,0,0,0,0,16032,6.8,17171,220,45,-2222,-1252,22.0,1603.2,15,1,1,9,5,10,1,1,0,0,18254,7.0,18423,225,40,2222,1252,22.5,1825.4
4525084228,1,19,5,0,4,4,4,0,0,0,0,14892,6.8,17899,199,49,-1750,-628,19.9,1489.2,19,4,1,4,4,4,1,1,0,0,16642,7.2,18527,250,61,1750,628,25.0,1664.2
4502255242,0,16,2,1,6,4,7,1,1,0,0,16643,7.0,18300,215,51,1515,590,21.5,1664.3,25,2,0,4,6,4,0,0,0,0,15128,6.8,17710,207,56,-1515,-590,20.7,1512.8
4512891613,0,18,1,1,8,3,10,0,0,0,0,17818,7.2,19558,238,44,2534,1730,23.8,1781.8,11,3,0,3,8,2,0,0,0,0,15284,7.0,17828,223,60,-2534,-1730,22.3,1528.4
4468739944,1,17,2,0,8,5,16,1,1,0,0,16291,6.8,16847,179,42,478,1166,17.9,1629.1,20,4,1,5,8,8,0,0,0,0,15813,6.4,15681,205,40,-478,-1166,20.5,1581.3
4439479847,0,12,3,1,4,5,4,1,1,0,0,16229,7.2,18834,247,48,960,813,24.7,1622.9,16,3,0,5,4,5,0,0,0,0,15269,6.8,18021,201,51,-960,-813,20.1,1526.9
4524546910,0,146,0,0,1,11,1,0,0,0,0,13943,6.2,16274,204,56,-5302,-3981,20.4,1394.3,50,3,1,11,1,13,0,0,0,0,19245,7.4,20255,238,64,5302,3981,23.8,1924.5
4515440018,0,136,7,1,6,5,3,1,0,1,1,17174,7.0,18458,231,49,507,510,23.1,1717.4,38,2,0,5,6,5,1,1,0,0,16667,7.0,17948,233,57,-507,-510,23.3,1666.7
4445189250,0,19,2,1,2,5,1,1,1,0,0,14902,7.0,17656,242,44,-1186,-892,24.2,1490.2,14,4,0,5,2,6,0,0,0,0,16088,7.0,18548,215,47,1186,892,21.5,1608.8
4523706574,0,15,5,0,5,11,4,0,0,0,0,14975,6.4,15932,194,44,-3359,-2255,19.4,1497.5,17,4,1,11,5,8,1,1,0,0,18334,7.0,18187,221,60,3359,2255,22.1,1833.4
4527276580,1,17,1,1,6,3,5,1,1,0,0,16563,7.0,18392,215,52,1786,-5,21.5,1656.3,13,0,0,3,6,2,0,0,0,0,14777,7.0,18397,201,63,-1786,5,20.1,1477.7
4509254722,1,13,3,0,6,10,6,1,1,0,0,16279,7.0,18734,226,56,-1753,-1095,22.6,1627.9,16,5,1,10,6,6,0,0,0,0,18032,7.0,19829,253,52,1753,1095,25.3,1803.2
4513383518,0,53,2,0,0,3,0,1,1,0,0,13787,6.8,17848,225,52,-2153,-1344,22.5,1378.7,14,4,1,3,0,3,0,0,0,0,15940,7.2,19192,237,56,2153,1344,23.7,1594.0
4505884702,1,13,3,0,6,2,5,0,0,0,0,17059,7.2,18997,268,52,2714,2819,26.8,1705.9,82,1,1,2,6,2,0,0,0,0,14345,6.6,16178,209,38,-2714,-2819,20.9,1434.5
4410578219,1,42,5,1,10,5,15,0,0,0,0,18062,6.8,17582,220,33,2301,667,22.0,1806.2,25,5,0,5,10,9,1,1,0,0,15761,6.6,16915,204,52,-2301,-667,20.4,1576.1
4520613300,1,23,6,0,3,4,5,0,0,0,0,15390,7.0,18666,245,51,-387,879,24.5,1539.0,17,5,1,4,3,8,0,0,0,0,15777,7.0,17787,239,55,387,-879,23.9,1577.7
4412978193,1,15,0,1,10,7,11,2,1,1,0,16743,6.6,17531,189,44,52,221,18.9,1674.3,14,2,0,7,10,5,0,0,0,0,16691,6.8,17310,208,38,-52,-221,20.8,1669.1
4438038380,0,17,2,1,7,5,10,0,0,0,0,17098,7.2,18682,229,58,1733,862,22.9,1709.8,55,2,0,5,7,4,1,1,0,0,15365,6.8,17820,206,63,-1733,-862,20.6,1536.5
4507083643,1,15,1,1,11,8,15,2,1,1,0,17640,6.6,17082,164,45,1252,-271,16.4,1764.0,14,3,0,8,11,11,0,0,0,0,16388,6.8,17353,176,52,-1252,271,17.6,1638.8
4511386287,0,19,7,1,10,7,8,1,1,0,1,18822,7.0,18319,224,51,2830,1605,22.4,1882.2,21,1,0,7,10,5,1,0,1,0,15992,6.6,16714,195,47,-2830,-1605,19.5,1599.2
4474786216,1,17,2,0,9,2,11,2,1,1,0,17259,7.0,18091,214,52,3146,2257,21.4,1725.9,14,2,1,2,9,1,0,0,0,0,14113,6.4,15834,221,33,-3146,-2257,22.1,1411.3
4523682981,1,17,1,1,11,2,12,1,1,0,0,19967,7.0,19474,246,68,5887,4222,24.6,1996.7,16,1,0,2,11,2,0,0,0,0,14080,6.2,15252,209,44,-5887,-4222,20.9,1408.0
4459102512,1,15,1,1,9,6,12,0,0,0,0,17027,6.8,17004,175,49,573,48,17.5,1702.7,16,2,0,6,9,11,0,0,0,0,16454,7.0,16956,191,56,-573,-48,19.1,1645.4
4522393633,0,18,8,0,4,5,5,1,1,0,0,15453,6.8,17463,191,55,-839,-623,19.1,1545.3,46,6,1,5,4,6,0,0,0,0,16292,6.8,18086,201,49,839,623,20.1,1629.2
4519680477,1,18,2,1,8,3,7,1,1,0,0,17828,7.2,19155,242,65,3642,3850,24.2,1782.8,38,6,0,3,8,3,0,0,0,0,14186,6.2,15305,179,34,-3642,-3850,17.9,1418.6
4492342077,1,14,1,1,8,7,7,1,1,0,0,17717,7.4,19042,203,66,1227,996,20.3,1771.7,14,0,0,7,8,8,0,0,0,0,16490,6.8,18046,225,49,-1227,-996,22.5,1649.0
4522366207,0,30,3,0,3,7,3,0,0,0,0,14668,6.6,16196,197,52,-2440,-2239,19.7,1466.8,21,5,1,7,3,6,1,1,0,0,17108,7.2,18435,230,55,2440,2239,23.0,1710.8
4466996593,0,17,4,0,8,5,9,1,1,0,0,17027,7.4,19345,217,56,302,1420,21.7,1702.7,18,5,1,5,8,7,1,0,1,0,16725,7.0,17925,237,44,-302,-1420,23.7,1672.5
4511505654,0,105,3,0,5,11,4,0,0,0,0,15617,6.6,17334,202,63,-3516,-2677,20.2,1561.7,11,3,1,11,5,6,1,0,1,0,19133,7.4,20011,237,52,3516,2677,23.7,1913.3
4472611324,0,25,7,1,6,3,6,0,0,0,0,15048,7.0,17356,183,34,-1138,-867,18.3,1504.8,17,7,0,3,6,3,1,1,0,0,16186,7.0,18223,253,54,1138,867,25.3,1618.6
4524693952,0,53,2,0,6,8,8,1,1,0,0,15128,6.2,15881,172,37,-1187,-1137,17.2,1512.8,20,2,1,8,6,9,0,0,0,0,16315,6.8,17018,179,40,1187,1137,17.9,1631.5
4527044797,0,15,0,0,5,10,5,0,0,0,0,15954,6.8,16521,192,56,-2527,-2193,19.2,1595.4,14,3,1,10,5,8,1,1,0,0,18481,7.4,18714,197,80,2527,2193,19.7,1848.1
4524968728,0,17,2,0,5,11,7,0,0,0,0,15881,6.8,17927,214,39,-1943,-1582,21.4,1588.1,60,3,1,11,5,7,1,1,0,0,17824,7.2,19509,216,45,1943,1582,21.6,1782.4
4512974012,0,14,3,0,0,6,0,0,0,0,0,14197,6.8,17915,255,54,-2313,-1210,25.5,1419.7,60,3,1,6,0,6,0,0,0,0,16510,7.2,19125,231,64,2313,1210,23.1,1651.0
4523323599,1,20,10,0,9,11,10,1,0,1,0,17298,6.8,17146,198,40,-98,-169,19.8,1729.8,47,5,1,11,9,13,1,1,0,0,17396,7.0,17315,182,36,98,169,18.2,1739.6
4518215400,0,18,1,0,7,8,5,0,0,0,0,16768,7.2,19368,225,58,-268,-155,22.5,1676.8,15,2,1,8,7,9,1,1,0,0,17036,7.2,19523,221,65,268,155,22.1,1703.6
4512168503,0,18,4,0,4,7,3,2,1,1,0,15210,6.8,17099,185,72,-2630,-2244,18.5,1521.0,19,4,1,7,4,6,0,0,0,0,17840,7.2,19343,222,71,2630,2244,22.2,1784.0
4516719935,1,13,2,0,2,4,2,1,1,0,0,15312,7.0,18210,250,61,-961,-725,25.0,1531.2,16,4,1,4,2,3,0,0,0,0,16273,7.2,18935,250,56,961,725,25.0,1627.3
4525018915,0,20,5,1,4,6,4,0,0,0,0,15688,6.6,16920,226,53,-162,-553,22.6,1568.8,20,7,0,6,4,10,0,0,0,0,15850,7.0,17473,233,44,162,553,23.3,1585.0
4518209107,1,13,3,0,13,9,12,1,1,0,0,20541,7.4,19687,260,60,2368,1767,26.0,2054.1,28,3,1,9,13,16,0,0,0,0,18173,6.8,17920,169,52,-2368,-1767,16.9,1817.3
4520613359,0,18,2,0,2,2,2,0,0,0,0,15608,6.8,17516,260,47,766,331,26.0,1560.8,37,5,1,2,2,2,0,0,0,0,14842,7.0,17185,229,52,-766,-331,22.9,1484.2
4514255015,0,16,5,0,4,9,5,1,1,0,0,15395,6.6,17472,221,44,-1421,-1367,22.1,1539.5,15,2,1,9,4,6,1,0,1,0,16816,7.0,18839,212,60,1421,1367,21.2,1681.6
4510687386,0,13,3,0,3,7,2,0,0,0,0,15226,6.8,17102,210,64,-1207,-218,21.0,1522.6,22,1,1,7,3,7,0,0,0,0,16433,6.6,17320,215,44,1207,218,21.5,1643.3
4440235143,1,15,3,1,9,8,13,1,0,1,0,18146,6.6,17263,199,40,383,-1655,19.9,1814.6,19,2,0,8,9,10,0,0,0,0,17763,7.4,18918,201,60,-383,1655,20.1,1776.3
4500293065,1,17,5,0,6,1,12,1,1,0,0,16009,6.8,17605,194,51,685,333,19.4,1600.9,17,1,1,1,6,0,0,0,0,0,15324,6.6,17272,252,72,-685,-333,25.2,1532.4
4502893432,1,18,1,0,5,6,6,1,0,1,0,15987,7.0,17964,207,44,-155,-47,20.7,1598.7,12,4,1,6,5,6,0,0,0,0,16142,7.0,18011,231,39,155,47,23.1,1614.2
4464614548,0,12,1,0,2,7,1,1,0,1,0,15051,6.8,17519,220,57,-2815,-1204,22.0,1505.1,16,1,1,7,2,8,0,0,0,0,17866,7.2,18723,236,52,2815,1204,23.6,1786.6
4451877968,1,16,1,1,5,3,4,1,0,1,0,16415,6.8,17432,213,38,1419,82,21.3,1641.5,22,5,0,3,5,2,1,1,0,0,14996,6.8,17350,223,52,-1419,-82,22.3,1499.6
4500305709,0,15,2,0,6,10,8,1,1,0,0,15875,7.0,18029,191,60,-2901,-1904,19.1,1587.5,17,1,1,10,6,8,0,0,0,0,18776,7.2,19933,230,56,2901,1904,23.0,1877.6
4506503377,1,13,4,1,8,9,8,1,1,0,0,17800,7.2,19759,223,72,-95,194,22.3,1780.0,12,3,0,9,8,9,0,0,0,0,17895,7.0,19565,232,52,95,-194,23.2,1789.5
4525312884,1,16,2,1,7,3,7,1,1,0,0,17639,7.2,18319,247,47,2392,1200,24.7,1763.9,14,4,0,3,7,3,0,0,0,0,15247,6.8,17119,214,48,-2392,-1200,21.4,1524.7
4520501061,1,14,3,0,6,6,6,0,0,0,0,17023,7.2,19264,255,66,671,804,25.5,1702.3,18,0,1,6,6,10,0,0,0,0,16352,6.8,18460,231,60,-671,-804,23.1,1635.2
4470382093,0,16,4,1,6,8,5,0,0,0,0,16625,7.2,18202,226,48,-810,-730,22.6,1662.5,17,4,0,8,6,9,0,0,0,0,17435,7.4,18932,234,48,810,730,23.4,1743.5
4481832485,0,22,3,0,4,7,6,1,0,1,0,16135,7.0,18177,234,47,-1782,-1311,23.4,1613.5,17,3,1,7,4,8,1,1,0,0,17917,7.2,19488,264,53,1782,1311,26.4,1791.7
4519842459,1,15,3,1,11,4,15,0,0,0,0,19432,7.2,19227,228,43,3857,2660,22.8,1943.2,19,2,0,4,11,6,1,1,0,0,15575,6.6,16567,210,53,-3857,-2660,21.0,1557.5
4434732074,1,19,3,0,2,6,1,1,1,0,0,14107,6.6,17015,180,72,-1699,-364,18.0,1410.7,20,3,1,6,2,10,0,0,0,0,15806,6.8,17379,220,40,1699,364,22.0,1580.6
4485904786,0,15,5,1,3,9,2,1,1,0,0,15000,6.6,16731,221,51,-3761,-2552,22.1,1500.0,31,2,0,9,3,7,0,0,0,0,18761,7.2,19283,225,48,3761,2552,22.5,1876.1
4472164226,1,14,3,1,11,6,15,1,1,0,0,18606,7.2,19254,214,45,2526,1625,21.4,1860.6,12,2,0,6,11,4,0,0,0,0,16080,7.0,17629,225,48,-2526,-1625,22.5,1608.0
4521619561,1,11,2,1,14,6,12,0,0,0,0,19588,7.2,19987,217,45,3864,2988,21.7,1958.8,28,1,0,6,14,10,0,0,0,0,15724,6.8,16999,162,50,-3864,-2988,16.2,1572.4
4462178191,1,19,2,1,7,0,9,1,1,0,1,18745,7.0,18917,259,48,4783,2851,25.9,1874.5,12,1,0,0,7,0,1,0,1,0,13962,6.4,16066,217,64,-4783,-2851,21.7,1396.2
4510180756,0,35,3,1,8,4,11,1,1,0,0,17857,7.2,19272,239,51,2374,1332,23.9,1785.7,16,3,0,4,8,3,0,0,0,0,15483,7.0,17940,239,52,-2374,-1332,23.9,1548.3
4475339734,0,64,2,0,2,3,1,0,0,0,0,13875,6.4,16214,212,46,-1207,-1542,21.2,1387.5,19,6,1,3,2,3,0,0,0,0,15082,7.0,17756,227,37,1207,1542,22.7,1508.2
4468771669,0,19,3,1,4,9,4,1,0,1,0,15628,6.8,16659,233,42,-2316,-2043,23.3,1562.8,18,4,0,9,4,10,0,0,0,0,17944,7.0,18702,243,40,2316,2043,24.3,1794.4
4513948107,1,20,3,1,11,6,13,1,1,0,0,18401,7.0,18465,201,51,1843,1402,20.1,1840.1,16,3,0,6,11,8,0,0,0,0,16558,6.8,17063,212,36,-1843,-1402,21.2,1655.8
4516562563,0,14,1,0,9,6,10,0,0,0,0,16760,6.8,16804,193,42,226,-957,19.3,1676.0,13,2,1,6,9,2,0,0,0,0,16534,6.8,17761,213,55,-226,957,21.3,1653.4
4517631475,0,16,1,0,5,10,6,0,0,0,0,15994,6.8,17730,211,50,-2028,-1740,21.1,1599.4,12,3,1,10,5,7,1,1,0,0,18022,7.2,19470,242,58,2028,1740,24.2,1802.2
4482132906,1,17,5,1,9,3,7,0,0,0,0,16646,7.0,18209,236,32,2522,2156,23.6,1664.6,21,5,0,3,9,3,1,1,0,0,14124,6.6,16053,210,43,-2522,-2156,21.0,1412.4
4452824789,0,34,3,0,2,7,2,0,0,0,0,14135,6.8,17185,220,37,-2711,-2547,22.0,1413.5,13,2,1,7,2,7,0,0,0,0,16846,7.2,19732,230,58,2711,2547,23.0,1684.6
4522194078,0,14,3,1,2,5,2,0,0,0,0,14695,6.8,17431,228,56,-2062,-1466,22.8,1469.5,13,3,0,5,2,6,1,1,0,0,16757,7.0,18897,246,58,2062,1466,24.6,1675.7
4501004124,1,18,2,1,8,2,9,1,0,1,1,18188,7.0,18675,208,49,3263,1440,20.8,1818.8,16,3,0,2,8,2,1,1,0,0,14925,6.8,17235,200,68,-3263,-1440,20.0,1492.5
4522214427,0,44,3,0,4,6,2,1,1,0,0,15044,7.0,17888,214,48,-2127,-997,21.4,1504.4,33,5,1,6,4,8,0,0,0,0,17171,7.2,18885,228,59,2127,997,22.8,1717.1
4512913824,1,14,5,1,11,5,12,1,1,0,0,18632,7.2,19093,227,44,2907,1175,22.7,1863.2,42,3,0,5,11,8,0,0,0,0,15725,7.0,17918,204,53,-2907,-1175,20.4,1572.5
4521648781,1,20,3,1,10,6,11,0,0,0,0,19000,7.2,18915,233,39,1259,-60,23.3,1900.0,17,5,0,6,10,7,0,0,0,0,17741,7.0,18975,264,44,-1259,60,26.4,1774.1
4518078785,1,11,4,0,15,7,16,1,0,1,0,20880,7.4,21004,231,41,4294,2560,23.1,2088.0,12,0,1,7,15,7,1,1,0,0,16586,7.0,18444,216,61,-4294,-2560,21.6,1658.6
4518030452,0,11,2,1,7,11,11,0,0,0,0,17444,6.4,16497,213,42,-1642,-4442,21.3,1744.4,11,1,0,11,7,16,1,1,0,0,19086,7.6,20939,223,71,1642,4442,22.3,1908.6
4520601060,0,77,2,0,7,15,6,0,0,0,0,16523,7.0,17836,219,38,-2692,-2753,21.9,1652.3,15,2,1,15,7,12,1,1,0,0,19215,7.6,20589,176,61,2692,2753,17.6,1921.5
4463558465,1,15,4,1,7,7,8,0,0,0,0,15887,6.8,17319,171,57,-560,-1443,17.1,1588.7,16,1,0,7,7,3,0,0,0,0,16447,7.0,18762,209,39,560,1443,20.9,1644.7
4502908431,0,58,2,0,10,9,19,1,1,0,0,17583,7.0,17639,201,48,-236,-1078,20.1,1758.3,23,2,1,9,10,13,0,0,0,0,17819,7.2,18717,225,60,236,1078,22.5,1781.9
4437082520,0,16,4,1,10,6,11,1,1,0,0,17538,7.0,19111,219,48,34,145,21.9,1753.8,16,2,0,6,10,6,0,0,0,0,17504,7.2,18966,225,68,-34,-145,22.5,1750.4
4512229508,1,20,1,0,7,9,6,0,0,0,0,17214,7.0,18251,231,49,-1806,123,23.1,1721.4,23,6,1,9,7,13,1,1,0,1,19020,7.0,18128,204,54,1806,-123,20.4,1902.0
4526623923,1,17,2,1,8,4,8,1,1,0,0,16843,6.6,17489,204,40,2198,10,20.4,1684.3,17,2,0,4,8,3,1,0,1,0,14645,6.8,17479,206,43,-2198,-10,20.6,1464.5
4525109552,1,16,4,0,4,5,2,0,0,0,0,14826,6.8,16660,204,49,-1596,-1318,20.4,1482.6,16,4,1,5,4,7,1,0,1,0,16422,7.0,17978,214,57,1596,1318,21.4,1642.2
4499814815,0,11,2,0,7,9,5,0,0,0,0,15939,6.6,16482,205,31,-1323,-1025,20.5,1593.9,15,0,1,9,7,6,0,0,0,0,17262,6.8,17507,167,34,1323,1025,16.7,1726.2
4462548167,0,14,2,1,5,9,7,1,1,0,0,15530,6.8,17375,220,60,-2141,-52,22.0,1553.0,40,7,0,9,5,12,1,0,1,0,17671,6.8,17427,236,35,2141,52,23.6,1767.1
4519515708,1,19,1,1,11,1,18,1,1,0,0,18190,7.6,20017,225,65,4069,3954,22.5,1819.0,16,5,0,1,11,1,0,0,0,0,14121,6.6,16063,224,51,-4069,-3954,22.4,1412.1
4517858736,0,14,2,1,6,3,7,0,0,0,0,16310,7.0,18578,235,48,690,998,23.5,1631.0,18,1,0,3,6,5,1,1,0,0,15620,6.8,17580,230,40,-690,-998,23.0,1562.0
4477453234,0,18,2,1,2,1,3,0,0,0,0,14485,6.6,17358,211,40,-953,-862,21.1,1448.5,19,3,0,1,2,2,0,0,0,0,15438,7.0,18220,246,60,953,862,24.6,1543.8
4521342021,0,109,2,0,0,5,0,0,0,0,0,13557,6.6,16944,213,60,-2637,-1878,21.3,1355.7,36,6,1,5,0,8,1,1,0,0,16194,6.8,18822,248,52,2637,1878,24.8,1619.4
4519124601,0,17,3,1,4,4,3,1,1,0,0,15842,7.0,18640,240,60,71,409,24.0,1584.2,17,5,0,4,4,6,0,0,0,0,15771,7.0,18231,227,48,-71,-409,22.7,1577.1
4523399536,1,16,3,1,6,2,6,1,1,0,0,16610,7.0,18953,231,56,1353,1332,23.1,1661.0,23,1,0,2,6,2,0,0,0,0,15257,6.8,17621,236,46,-1353,-1332,23.6,1525.7
4500506484,1,31,4,1,5,5,10,1,1,0,0,16737,6.8,17553,231,52,272,-467,23.1,1673.7,15,2,0,5,5,8,0,0,0,0,16465,7.0,18020,218,48,-272,467,21.8,1646.5
4527454154,0,19,5,1,13,12,19,0,0,0,0,19362,6.6,17316,195,28,965,1856,19.5,1936.2,16,2,0,12,13,20,1,0,1,0,18397,6.4,15460,180,40,-965,-1856,18.0,1839.7
4468503240,1,91,3,0,10,5,13,0,0,0,1,19571,7.2,18463,213,50,4006,2081,21.3,1957.1,17,1,1,5,10,6,0,0,0,0,15565,6.6,16382,210,47,-4006,-2081,21.0,1556.5
4527484965,0,17,3,0,4,11,5,0,0,0,0,14702,6.6,16103,193,33,-3191,-1620,19.3,1470.2,27,4,1,11,4,17,1,1,0,0,17893,7.0,17723,219,48,3191,1620,21.9,1789.3
4494748194,1,15,4,1,12,5,18,2,1,1,1,20176,7.0,18972,218,60,4634,2354,21.8,2017.6,16,0,0,5,12,3,0,0,0,0,15542,6.6,16618,217,43,-4634,-2354,21.7,1554.2
4522643294,0,13,13,0,4,9,8,0,0,0,0,15400,6.6,16910,219,34,-2564,-1518,21.9,1540.0,38,1,1,9,4,10,0,0,0,0,17964,6.8,18428,229,56,2564,1518,22.9,1796.4
4512915759,0,16,4,0,1,5,2,0,0,0,0,13286,6.2,15085,187,48,-4179,-3823,18.7,1328.6,20,4,1,5,1,4,1,1,0,0,17465,7.0,18908,236,67,4179,3823,23.6,1746.5
4520909280,0,15,3,0,4,11,2,1,1,0,0,15011,6.6,16617,183,60,-4396,-2703,18.3,1501.1,14,3,1,11,4,16,0,0,0,0,19407,7.2,19320,245,40,4396,2703,24.5,1940.7
4526761574,1,79,2,0,3,3,2,0,0,0,0,15471,6.8,18349,219,51,-251,560,21.9,1547.1,14,2,1,3,3,7,0,0,0,0,15722,7.0,17789,255,52,251,-560,25.5,1572.2
4522288723,1,17,3,1,6,3,9,1,1,0,0,16198,6.8,17866,226,44,1873,1987,22.6,1619.8,18,2,0,3,6,4,0,0,0,0,14325,6.4,15879,179,44,-1873,-1987,17.9,1432.5
4497747862,1,17,3,0,10,10,10,0,0,0,0,19035,7.2,18221,219,38,120,1209,21.9,1903.5,13,1,1,10,10,10,1,0,1,1,18915,6.6,17012,208,31,-120,-1209,20.8,1891.5
4522772172,0,15,1,1,6,14,6,0,0,0,0,16197,6.4,15405,203,40,-2941,-3143,20.3,1619.7,81,3,0,14,6,16,1,1,0,0,19138,7.0,18548,194,54,2941,3143,19.4,1913.8
4507364273,1,14,1,1,12,2,8,1,0,1,0,18863,7.6,20134,238,52,4785,4475,23.8,1886.3,13,1,0,2,12,2,0,0,0,0,14078,6.4,15659,206,42,-4785,-4475,20.6,1407.8
4505942636,1,15,8,0,9,4,9,0,0,0,0,18099,7.0,18989,238,56,2420,2272,23.8,1809.9,20,2,1,4,9,4,1,1,0,0,15679,6.6,16717,218,50,-2420,-2272,21.8,1567.9
4463393094,0,12,2,0,5,7,3,0,0,0,0,16206,7.0,17906,229,53,-33,1233,22.9,1620.6,14,3,1,7,5,8,1,1,0,0,16239,6.6,16673,200,40,33,-1233,20.0,1623.9
4526291828,1,17,0,0,5,2,3,2,1,1,0,17956,7.0,18251,271,50,4594,2745,27.1,1795.6,18,3,1,2,5,6,0,0,0,0,13362,6.4,15506,187,33,-4594,-2745,18.7,1336.2
4517186404,1,16,2,1,10,9,9,1,1,0,0,19219,7.0,18673,229,50,2346,1776,22.9,1921.9,9,0,0,9,10,10,0,0,0,0,16873,6.8,16897,177,35,-2346,-1776,17.7,1687.3
4495272249,0,14,2,0,5,6,3,1,0,1,0,15432,6.6,16542,223,24,-1042,-2030,22.3,1543.2,20,1,1,6,5,8,1,1,0,0,16474,7.0,18572,221,64,1042,2030,22.1,1647.4
4522390017,1,17,4,1,4,3,4,0,0,0,0,15202,6.8,17438,215,53,145,-729,21.5,1520.2,49,2,0,3,4,2,1,0,1,0,15057,6.8,18167,247,60,-145,729,24.7,1505.7
4523110333,1,18,4,1,6,7,10,2,1,1,0,17259,7.0,19074,236,67,-214,1004,23.6,1725.9,84,3,0,7,6,8,0,0,0,0,17473,7.0,18070,225,46,214,-1004,22.5,1747.3
4511640654,1,58,7,0,5,2,8,0,0,0,0,16385,7.0,18788,222,68,1421,1097,22.2,1638.5,28,3,1,2,5,4,1,1,0,0,14964,7.0,17691,215,61,-1421,-1097,21.5,1496.4
4514070165,0,12,0,0,10,7,11,0,0,0,1,20278,7.2,19575,236,58,4633,2269,23.6,2027.8,20,1,1,7,10,6,1,1,0,0,15645,6.6,17306,182,45,-4633,-2269,18.2,1564.5
4519425704,1,15,7,1,11,5,12,0,0,0,0,18480,6.8,17912,201,42,2532,1229,20.1,1848.0,14,3,0,5,11,10,0,0,0,0,15948,6.6,16683,203,51,-2532,-1229,20.3,1594.8
4477392695,1,18,5,1,10,9,10,0,0,0,0,17335,6.6,16110,176,48,1287,-749,17.6,1733.5,16,3,0,9,10,11,1,1,0,0,16048,6.6,16859,198,40,-1287,749,19.8,1604.8
4522539833,0,70,11,0,6,5,5,1,0,1,0,16500,6.8,18497,202,47,496,1530,20.2,1650.0,47,1,1,5,6,6,1,1,0,0,16004,6.8,16967,222,40,-496,-1530,22.2,1600.4
4501457414,0,13,1,0,5,7,8,0,0,0,0,16334,7.0,18034,245,40,-1337,-1106,24.5,1633.4,85,1,1,7,5,9,2,1,1,0,17671,7.2,19140,245,60,1337,1106,24.5,1767.1
4522608036,0,22,4,0,7,2,5,0,0,0,0,16696,7.2,18900,225,68,1945,2614,22.5,1669.6,17,4,1,2,7,3,0,0,0,0,14751,6.4,16286,196,52,-1945,-2614,19.6,1475.1
4518753838,0,14,1,1,5,3,5,0,0,0,0,15892,6.8,18043,216,48,822,25,21.6,1589.2,13,1,0,3,5,3,2,1,1,0,15070,7.2,18018,229,55,-822,-25,22.9,1507.0
4526227837,1,15,2,0,11,7,9,0,0,0,0,19425,7.4,20998,218,67,3143,2852,21.8,1942.5,16,2,1,7,11,5,1,1,0,0,16282,7.0,18146,216,56,-3143,-2852,21.6,1628.2
4508863080,1,16,6,0,3,5,3,1,1,0,0,16040,7.0,18690,248,72,-877,-813,24.8,1604.0,14,2,1,5,3,6,0,0,0,0,16917,7.2,19503,264,52,877,813,26.4,1691.7
4518392490,1,17,3,0,9,7,9,1,1,0,0,19034,7.4,19369,240,43,4051,3552,24.0,1903.4,15,1,1,7,9,6,0,0,0,0,14983,6.6,15817,178,28,-4051,-3552,17.8,1498.3
4510870586,1,15,3,1,4,2,5,1,1,0,0,15800,6.8,17445,209,47,295,791,20.9,1580.0,43,2,0,2,4,3,1,0,1,1,15505,6.8,16654,206,45,-295,-791,20.6,1550.5
4499786529,1,86,3,1,6,10,5,0,0,0,0,17040,7.0,17805,215,50,-545,-1102,21.5,1704.0,17,6,0,10,6,9,1,1,0,0,17585,7.0,18907,214,40,545,1102,21.4,1758.5
4492137398,1,16,3,1,6,2,6,1,1,0,0,16605,6.8,17533,219,46,2086,360,21.9,1660.5,17,5,0,2,6,1,1,0,1,0,14519,6.6,17173,210,44,-2086,-360,21.0,1451.9
4500814768,1,22,2,1,6,4,9,1,1,0,0,16231,6.8,17392,222,50,124,-2259,22.2,1623.1,13,3,0,4,6,2,0,0,0,0,16107,7.4,19651,239,68,-124,2259,23.9,1610.7
4524637878,0,15,2,0,7,7,7,0,0,0,0,17332,7.0,18724,226,60,-6,1004,22.6,1733.2,15,1,1,7,7,9,2,1,1,0,17338,6.8,17720,188,56,6,-1004,18.8,1733.8
4496837103,0,13,2,0,2,7,3,1,0,1,0,14624,6.8,16881,210,57,-2089,537,21.0,1462.4,39,5,1,7,2,10,0,0,0,0,16713,6.6,16344,215,38,2089,-537,21.5,1671.3
4478267936,0,16,3,0,6,5,7,0,0,0,0,17065,7.0,18634,220,50,1019,327,22.0,1706.5,18,1,1,5,6,7,1,1,0,0,16046,7.0,18307,233,50,-1019,-327,23.3,1604.6
4506218156,0,17,1,1,11,7,6,0,0,0,0,17500,7.2,18895,193,54,658,747,19.3,1750.0,13,1,0,7,11,10,0,0,0,0,16842,6.8,18148,193,64,-658,-747,19.3,1684.2
4522518445,0,42,6,0,8,7,8,0,0,0,0,16699,7.0,17881,240,40,320,-743,24.0,1669.9,38,13,1,7,8,6,1,1,0,0,16379,7.2,18624,216,48,-320,743,21.6,1637.9
4520004131,1,14,4,1,5,5,4,1,1,0,0,15885,6.6,16411,213,54,-508,-1263,21.3,1588.5,35,1,0,5,5,5,0,0,0,0,16393,7.0,17674,235,46,508,1263,23.5,1639.3
4474587492,0,12,1,0,5,11,3,0,0,0,0,16007,6.6,17004,206,64,-3397,-2492,20.6,1600.7,18,3,1,11,5,8,1,1,0,1,19404,7.2,19496,229,68,3397,2492,22.9,1940.4
4519145907,1,13,3,0,4,6,3,2,1,1,0,15695,7.2,18493,238,44,-300,451,23.8,1569.5,11,2,1,6,4,5,0,0,0,0,15995,7.2,18042,203,51,300,-451,20.3,1599.5
4505214335,0,12,3,1,4,7,4,0,0,0,0,15580,6.8,17701,205,52,-731,-118,20.5,1558.0,14,0,0,7,4,6,2,1,1,0,16311,6.8,17819,229,54,731,118,22.9,1631.1
4515532917,0,15,6,1,3,5,5,0,0,0,0,14378,6.4,16230,209,39,-3682,-3599,20.9,1437.8,14,3,0,5,3,2,2,1,1,1,18060,7.4,19829,245,66,3682,3599,24.5,1806.0
4524133023,0,16,2,1,5,11,7,1,1,0,0,14587,6.2,14862,171,42,-3541,-4118,17.1,1458.7,12,1,0,11,5,12,0,0,0,0,18128,7.2,18980,218,40,3541,4118,21.8,1812.8
4507922418,0,40,3,0,11,9,10,1,1,0,0,18342,7.2,19368,190,65,-30,1414,19.0,1834.2,45,11,1,9,11,10,0,0,0,0,18372,7.0,17954,164,48,30,-1414,16.4,1837.2
4522493624,1,17,1,1,7,6,6,1,1,0,0,16737,7.2,18903,240,48,1411,1163,24.0,1673.7,14,2,0,6,7,3,0,0,0,0,15326,7.0,17740,177,49,-1411,-1163,17.7,1532.6
4499967324,1,17,3,1,6,4,7,0,0,0,0,17477,7.0,19006,232,64,1814,73,23.2,1747.7,14,0,0,4,6,4,1,1,0,0,15663,7.0,18933,210,72,-1814,-73,21.0,1566.3
4520894733,0,14,2,0,3,3,5,1,1,0,0,15518,6.6,16768,234,52,315,-61,23.4,1551.8,19,1,1,3,3,4,0,0,0,0,15203,6.6,16829,216,51,-315,61,21.6,1520.3
4458389228,1,20,5,1,11,8,9,0,0,0,0,18746,7.2,19066,225,44,2198,1355,22.5,1874.6,18,1,0,8,11,4,1,1,0,0,16548,6.8,17711,204,64,-2198,-1355,20.4,1654.8
4511678371,0,16,3,0,4,10,5,0,0,0,0,14993,6.4,16201,208,48,-3416,-2347,20.8,1499.3,18,1,1,10,4,12,1,1,0,0,18409,7.2,18548,206,64,3416,2347,20.6,1840.9
4527306086,1,11,2,1,15,10,19,1,1,0,0,19407,7.4,19360,217,42,1259,550,21.7,1940.7,11,2,0,10,15,11,0,0,0,0,18148,7.0,18810,193,54,-1259,-550,19.3,1814.8
4489870800,1,50,4,1,13,6,22,1,1,0,0,20876,7.6,21016,226,56,4988,3720,22.6,2087.6,17,4,0,6,13,6,1,0,1,0,15888,6.8,17296,212,51,-4988,-3720,21.2,1588.8
4486440363,0,38,1,1,3,11,5,0,0,0,0,14496,6.4,16377,215,48,-5003,-4682,21.5,1449.6,56,0,0,11,3,17,1,1,0,0,19499,7.6,21059,208,83,5003,4682,20.8,1949.9
4522438327,1,33,5,0,4,4,5,1,1,0,0,16476,6.6,17137,225,50,896,-140,22.5,1647.6,13,5,1,4,4,1,1,0,1,0,15580,6.8,17277,227,54,-896,140,22.7,1558.0
4503692429,0,13,2,0,1,9,1,0,0,0,0,13508,6.6,15474,186,50,-5373,-4474,18.6,1350.8,15,4,1,9,1,11,2,1,1,0,18881,7.2,19948,241,49,5373,4474,24.1,1888.1
4516642389,1,17,4,0,7,7,7,0,0,0,0,16683,7.2,18315,231,48,-396,481,23.1,1668.3,11,2,1,7,7,5,2,1,1,0,17079,6.8,17834,246,42,396,-481,24.6,1707.9
4521263272,0,12,15,1,4,3,5,1,1,0,0,15694,6.8,17914,219,52,1074,237,21.9,1569.4,57,2,0,3,4,2,0,0,0,0,14620,6.8,17677,210,48,-1074,-237,21.0,1462.0
4521508038,1,17,1,1,5,4,4,0,0,0,0,16450,7.0,18801,229,72,1771,1846,22.9,1645.0,18,0,0,4,5,4,1,1,0,0,14679,6.6,16955,194,46,-1771,-1846,19.4,1467.9
4461377893,1,17,1,1,8,2,9,1,0,1,0,17243,7.2,19173,233,50,3082,1360,23.3,1724.3,48,3,0,2,8,0,0,0,0,0,14161,6.6,17813,222,45,-3082,-1360,22.2,1416.1
4524895124,1,16,3,0,12,9,15,0,0,0,0,18106,6.6,16668,186,48,862,-442,18.6,1810.6,17,4,1,9,12,11,1,1,0,0,17244,6.8,17110,204,48,-862,442,20.4,1724.4
4519907649,1,16,3,1,13,5,18,1,1,0,0,19813,7.0,18543,236,32,4173,1912,23.6,1981.3,14,1,0,5,13,7,0,0,0,0,15640,6.6,16631,167,40,-4173,-1912,16.7,1564.0
4503426918,1,47,3,0,9,3,10,1,0,1,0,16795,7.4,19175,203,41,2011,2996,20.3,1679.5,88,1,1,3,9,3,1,1,0,0,14784,6.6,16179,202,46,-2011,-2996,20.2,1478.4
4480203372,0,13,2,0,9,4,12,0,0,0,1,19292,6.8,18197,213,49,4062,2332,21.3,1929.2,26,2,1,4,9,6,2,1,1,0,15230,6.4,15865,191,42,-4062,-2332,19.1,1523.0
4504512866,0,11,3,1,6,7,7,0,0,0,0,17330,7.0,17971,237,52,-365,-1278,23.7,1733.0,15,3,0,7,6,8,1,1,0,0,17695,7.2,19249,227,63,365,1278,22.7,1769.5
4517946996,0,23,2,0,1,9,2,0,0,0,0,12941,6.4,15085,178,43,-5519,-5521,17.8,1294.1,16,6,1,9,1,10,2,1,1,0,18460,7.6,20606,253,52,5519,5521,25.3,1846.0
4503839400,0,18,1,0,5,9,4,0,0,0,0,15167,6.6,16733,195,56,-2132,-1088,19.5,1516.7,17,3,1,9,5,7,0,0,0,0,17299,7.0,17821,215,42,2132,1088,21.5,1729.9
4520841378,1,13,3,0,4,7,3,1,1,0,0,16055,6.8,17933,227,55,93,1195,22.7,1605.5,15,1,1,7,4,9,0,0,0,0,15962,6.8,16738,214,36,-93,-1195,21.4,1596.2
4483298051,0,19,3,0,7,3,5,0,0,0,0,17235,7.4,19915,257,57,2648,2595,25.7,1723.5,14,6,1,3,7,3,0,0,0,0,14587,6.8,17320,191,52,-2648,-2595,19.1,1458.7
4497864725,1,20,7,1,11,2,16,0,0,0,0,19770,7.2,19116,232,48,5120,3137,23.2,1977.0,16,3,0,2,11,2,2,1,1,0,14650,6.4,15979,191,64,-5120,-3137,19.1,1465.0
4460980858,0,14,4,0,4,7,4,0,0,0,0,14630,6.4,16426,188,59,-1976,-2992,18.8,1463.0,19,1,1,7,4,7,1,1,0,0,16606,7.4,19418,230,49,1976,2992,23.0,1660.6
4462463336,0,11,6,1,5,15,5,1,1,0,0,16275,7.0,17526,199,64,-4202,-3846,19.9,1627.5,19,4,0,15,5,9,0,0,0,0,20477,7.8,21372,248,44,4202,3846,24.8,2047.7
4494314514,0,44,5,1,8,2,7,2,1,1,0,17298,7.2,18556,225,48,2975,2627,22.5,1729.8,18,2,0,2,8,3,0,0,0,0,14323,6.4,15929,211,44,-2975,-2627,21.1,1432.3
4461218405,1,16,2,1,11,4,9,1,1,0,0,19612,7.6,20290,259,50,4871,2019,25.9,1961.2,14,3,0,4,11,1,0,0,0,0,14741,7.0,18271,210,53,-4871,-2019,21.0,1474.1
4472715891,1,14,1,0,13,7,11,0,0,0,0,19253,7.2,19378,212,48,3044,1261,21.2,1925.3,11,0,1,7,13,5,1,1,0,0,16209,7.2,18117,212,55,-3044,-1261,21.2,1620.9
4464398381,0,18,1,0,7,10,8,0,0,0,0,15543,6.4,15357,193,44,-3333,-2568,19.3,1554.3,13,5,1,10,7,12,0,0,0,0,18876,7.0,17925,234,40,3333,2568,23.4,1887.6
4518022998,0,23,5,1,7,7,6,0,0,0,0,16313,6.8,16697,201,40,-1249,-3078,20.1,1631.3,17,8,0,7,7,5,0,0,0,0,17562,7.4,19775,228,59,1249,3078,22.8,1756.2
4487686105,1,12,4,1,8,4,11,0,0,0,0,16763,7.0,17757,216,34,147,-712,21.6,1676.3,14,2,0,4,8,8,0,0,0,0,16616,7.0,18469,240,64,-147,712,24.0,1661.6
4450463200,1,12,1,1,6,7,4,1,1,0,1,17149,6.8,17815,196,54,770,-46,19.6,1714.9,10,1,0,7,6,7,0,0,0,0,16379,7.0,17861,202,34,-770,46,20.2,1637.9
4503188502,1,20,9,1,6,6,6,0,0,0,0,16266,7.0,18203,208,40,1300,127,20.8,1626.6,27,7,0,6,6,4,1,1,0,0,14966,7.2,18076,155,66,-1300,-127,15.5,1496.6
4513354940,1,23,4,1,7,5,6,1,1,0,0,16946,6.8,17723,247,40,2276,1630,24.7,1694.6,15,6,0,5,7,7,0,0,0,0,14670,6.4,16093,194,29,-2276,-1630,19.4,1467.0
4523424930,1,15,6,1,4,4,7,0,0,0,0,16784,7.2,18335,267,47,992,-861,26.7,1678.4,14,2,0,4,4,5,1,1,0,0,15792,7.2,19196,224,80,-992,861,22.4,1579.2
4456330802,1,21,2,0,7,6,3,1,0,1,0,16653,7.4,19603,229,72,140,1737,22.9,1665.3,130,1,1,6,7,5,0,0,0,0,16513,7.0,17866,229,31,-140,-1737,22.9,1651.3
4515594785,1,18,1,1,7,1,11,1,1,0,0,17865,7.4,19102,238,53,3274,1659,23.8,1786.5,12,1,0,1,7,1,0,0,0,0,14591,6.8,17443,240,50,-3274,-1659,24.0,1459.1
4516639706,1,13,2,0,2,2,3,0,0,0,0,15397,6.8,17958,247,44,908,-79,24.7,1539.7,16,2,1,2,2,1,2,1,1,0,14489,6.8,18037,221,60,-908,79,22.1,1448.9
4503460732,1,16,1,1,9,2,9,1,0,1,0,17665,7.4,19246,232,45,3642,2198,23.2,1766.5,81,3,0,2,9,1,1,1,0,0,14023,7.0,17048,199,46,-3642,-2198,19.9,1402.3
4520333259,1,16,5,0,6,4,7,0,0,0,0,16619,7.2,18958,226,51,1552,1488,22.6,1661.9,31,4,1,4,6,5,0,0,0,0,15067,6.8,17470,213,52,-1552,-1488,21.3,1506.7
4506468475,1,17,4,1,7,8,8,1,1,0,0,16535,7.0,17930,230,28,-1123,-1665,23.0,1653.5,15,1,0,8,7,7,1,0,1,0,17658,7.0,19595,225,68,1123,1665,22.5,1765.8
4525540282,0,17,4,1,14,5,26,1,1,0,0,19452,7.0,18579,209,45,3682,1284,20.9,1945.2,16,2,0,5,14,6,0,0,0,0,15770,6.6,17295,207,56,-3682,-1284,20.7,1577.0
4487076086,0,97,3,0,11,7,20,1,1,0,0,17068,6.2,15357,153,32,786,-562,15.3,1706.8,16,2,1,7,11,8,0,0,0,0,16282,6.6,15919,199,40,-786,562,19.9,1628.2
4505453773,0,44,4,0,5,12,6,0,0,0,0,15851,6.6,16800,182,56,-3248,-2442,18.2,1585.1,19,0,1,12,5,9,1,1,0,0,19099,7.2,19242,243,44,3248,2442,24.3,1909.9
4519232603,1,15,4,1,11,6,21,1,1,0,0,17597,6.8,17045,190,50,2534,2539,19.0,1759.7,12,1,0,6,11,5,0,0,0,0,15063,6.2,14506,188,32,-2534,-2539,18.8,1506.3
4510127229,1,16,4,1,10,5,14,0,0,0,0,18538,7.2,19030,247,44,1806,632,24.7,1853.8,16,2,0,5,10,5,1,1,0,0,16732,7.0,18398,216,64,-1806,-632,21.6,1673.2
4493885121,1,16,2,0,7,2,7,0,0,0,0,16867,7.2,18880,226,47,2333,1998,22.6,1686.7,14,1,1,2,7,3,1,1,0,0,14534,6.6,16882,224,56,-2333,-1998,22.4,1453.4
4489994401,1,14,9,0,11,6,12,1,0,1,0,17850,7.4,18858,204,64,1926,3729,20.4,1785.0,17,0,1,6,11,8,1,1,0,0,15924,6.4,15129,167,39,-1926,-3729,16.7,1592.4
4504386463,0,20,2,1,5,6,4,1,0,1,0,15665,6.8,17716,203,48,-1730,-1236,20.3,1566.5,40,4,0,6,5,6,1,1,0,0,17395,7.0,18952,214,67,1730,1236,21.4,1739.5
4464979859,0,61,2,0,3,10,4,0,0,0,0,13539,6.6,15736,163,48,-5293,-3777,16.3,1353.9,31,2,1,10,3,13,0,0,0,0,18832,7.4,19513,236,63,5293,3777,23.6,1883.2
4516123957,0,17,5,1,8,6,16,1,1,0,0,17252,7.0,18419,197,48,-22,-801,19.7,1725.2,19,4,0,6,8,10,1,0,1,0,17274,7.2,19220,228,64,22,801,22.8,1727.4
4511150138,1,40,5,0,3,4,3,1,1,0,0,15458,7.2,19132,219,64,98,984,21.9,1545.8,16,3,1,4,3,2,0,0,0,0,15360,7.0,18148,240,48,-98,-984,24.0,1536.0
4527628313,0,14,4,1,2,3,3,1,1,0,0,14459,6.6,17229,224,48,-839,-1085,22.4,1445.9,66,4,0,3,2,1,0,0,0,0,15298,7.2,18314,247,40,839,1085,24.7,1529.8
4523612845,1,27,2,0,6,4,6,0,0,0,0,17591,7.2,18925,235,70,3208,3285,23.5,1759.1,15,4,1,4,6,2,0,0,0,0,14383,6.2,15640,186,52,-3208,-3285,18.6,1438.3
4517535335,1,27,9,0,6,5,6,1,1,0,0,16893,7.0,18950,238,64,568,1096,23.8,1689.3,43,8,1,5,6,6,0,0,0,0,16325,7.0,17854,231,48,-568,-1096,23.1,1632.5
4465803971,0,18,0,1,6,9,7,1,0,1,1,17077,6.8,16829,175,49,-995,-1497,17.5,1707.7,14,3,0,9,6,10,1,1,0,0,18072,7.2,18326,228,40,995,1497,22.8,1807.2
4516616203,1,23,0,0,2,5,1,0,0,0,0,15508,7.0,17985,258,60,-919,-923,25.8,1550.8,11,2,1,5,2,8,0,0,0,0,16427,7.2,18908,226,48,919,923,22.6,1642.7
4518772653,0,14,4,0,3,7,5,1,1,0,0,15070,6.8,18012,217,50,-2692,-1151,21.7,1507.0,15,3,1,7,3,14,0,0,0,0,17762,7.6,19163,225,52,2692,1151,22.5,1776.2
4523069290,1,24,2,1,6,5,3,0,0,0,0,16164,7.0,18306,226,63,113,-518,22.6,1616.4,15,3,0,5,6,9,1,1,0,0,16051,7.4,18824,223,52,-113,518,22.3,1605.1
4500313763,0,15,0,0,6,7,3,1,0,1,0,16132,7.0,18044,222,52,-1989,-735,22.2,1613.2,15,5,1,7,6,6,1,1,0,1,18121,7.4,18779,218,52,1989,735,21.8,1812.1
4487337497,0,13,1,1,6,5,9,1,1,0,0,16995,7.0,18679,230,64,930,567,23.0,1699.5,18,2,0,5,6,3,0,0,0,0,16065,7.0,18112,221,43,-930,-567,22.1,1606.5
4477407120,1,10,1,1,10,5,8,0,0,0,0,17465,6.8,17968,218,51,1428,463,21.8,1746.5,42,3,0,5,10,9,1,1,0,0,16037,6.8,17505,222,40,-1428,-463,22.2,1603.7
4424200095,0,16,3,1,9,9,10,1,1,0,0,17168,6.8,17668,212,40,-25,1849,21.2,1716.8,21,3,0,9,9,10,0,0,0,0,17193,6.6,15819,196,32,25,-1849,19.6,1719.3
4518151873,0,31,5,0,7,7,6,0,0,0,0,18282,7.0,19001,240,56,1542,1059,24.0,1828.2,18,2,1,7,7,7,1,1,0,0,16740,7.0,17942,212,59,-1542,-1059,21.2,1674.0
4486160462,0,14,0,1,3,2,3,1,0,1,0,14424,6.6,17499,201,48,-541,-66,20.1,1442.4,9,0,0,2,3,2,0,0,0,0,14965,6.8,17565,234,60,541,66,23.4,1496.5
4527309087,1,18,4,1,11,6,7,1,1,0,0,17795,7.2,19039,213,45,1395,1943,21.3,1779.5,14,2,0,6,11,8,0,0,0,0,16400,6.8,17096,198,50,-1395,-1943,19.8,1640.0
4523634644,1,17,2,1,7,4,8,2,1,1,1,18858,7.2,19023,237,66,4338,4607,23.7,1885.8,17,3,0,4,7,11,0,0,0,0,14520,6.2,14416,166,42,-4338,-4607,16.6,1452.0
4464955883,1,14,3,0,1,3,0,0,0,0,0,13918,7.0,17849,200,55,-1932,-41,20.0,1391.8,62,2,1,3,1,7,1,1,0,0,15850,6.8,17890,225,52,1932,41,22.5,1585.0
4518463006,0,40,3,0,10,8,10,0,0,0,0,17546,7.2,18498,191,44,510,921,19.1,1754.6,14,2,1,8,10,7,1,1,0,0,17036,7.0,17577,217,51,-510,-921,21.7,1703.6
4522454983,1,18,2,1,6,6,5,2,1,1,0,16604,7.0,17994,240,56,867,420,24.0,1660.4,16,4,0,6,6,3,0,0,0,0,15737,6.8,17574,205,40,-867,-420,20.5,1573.7
4518121275,1,20,1,1,7,6,8,1,1,0,0,16417,6.8,17202,205,56,161,130,20.5,1641.7,11,2,0,6,7,11,0,0,0,0,16256,6.8,17072,209,60,-161,-130,20.9,1625.6
4426718140,1,24,3,1,5,8,7,1,0,1,0,16137,6.6,17271,219,51,-80,-155,21.9,1613.7,16,6,0,8,5,9,1,1,0,0,16217,7.0,17426,205,40,80,155,20.5,1621.7
4516653257,1,17,3,1,6,8,7,1,1,0,0,16006,6.8,17612,233,47,-1493,-1266,23.3,1600.6,16,4,0,8,6,11,0,0,0,0,17499,7.0,18878,247,36,1493,1266,24.7,1749.9
4489800281,1,9,2,0,6,8,7,0,0,0,0,16730,7.0,17780,208,49,-828,-1255,20.8,1673.0,14,1,1,8,6,7,0,0,0,0,17558,7.2,19035,233,60,828,1255,23.3,1755.8
4466944349,0,20,2,0,4,6,3,0,0,0,0,15518,6.8,18114,241,44,-1630,-531,24.1,1551.8,16,3,1,6,4,8,1,1,0,0,17148,7.2,18645,243,64,1630,531,24.3,1714.8
4521698665,1,20,4,1,5,3,8,2,1,1,0,16321,7.0,18143,249,52,1151,-108,24.9,1632.1,17,1,0,3,5,4,0,0,0,0,15170,7.0,18251,218,47,-1151,108,21.8,1517.0
4479273649,0,10,0,0,3,5,8,0,0,0,0,14759,6.8,17310,194,56,-1394,-589,19.4,1475.9,13,1,1,5,3,7,1,1,0,0,16153,6.8,17899,246,44,1394,589,24.6,1615.3
4436503508,1,18,3,1,12,3,17,2,1,1,1,21016,7.4,20144,272,59,5512,3244,27.2,2101.6,50,1,0,3,12,6,0,0,0,0,15504,6.6,16900,212,56,-5512,-3244,21.2,1550.4
4484373881,0,17,1,1,6,4,8,2,1,1,0,17249,7.0,18964,239,56,1095,768,23.9,1724.9,12,4,0,4,6,6,0,0,0,0,16154,7.0,18196,247,56,-1095,-768,24.7,1615.4
4515490352,0,15,1,0,2,8,2,0,0,0,0,13956,6.6,16492,210,50,-3535,-1720,21.0,1395.6,16,2,1,8,2,12,1,1,0,0,17491,7.0,18212,203,63,3535,1720,20.3,1749.1
4520041745,0,20,1,0,7,11,10,0,0,0,0,16820,6.8,16714,202,40,-2234,-3264,20.2,1682.0,11,5,1,11,7,15,1,1,0,0,19054,7.2,19978,209,63,2234,3264,20.9,1905.4
4479461412,0,12,3,1,8,9,8,0,0,0,0,16957,6.6,17005,220,28,-206,-1872,22.0,1695.7,15,0,0,9,8,5,0,0,0,0,17163,7.2,18877,204,48,206,1872,20.4,1716.3
4499396422,1,40,6,1,4,4,8,0,0,0,0,15947,6.8,17352,231,41,247,-1191,23.1,1594.7,17,2,0,4,4,5,1,1,0,0,15700,6.8,18543,219,75,-247,1191,21.9,1570.0
4461787791,1,89,3,1,7,5,7,1,1,0,0,17488,7.2,18635,220,51,1902,967,22.0,1748.8,54,6,0,5,7,6,0,0,0,0,15586,7.0,17668,193,60,-1902,-967,19.3,1558.6
4526326403,1,40,3,0,5,6,5,1,1,0,0,16154,6.8,18329,235,42,-773,609,23.5,1615.4,11,1,1,6,5,8,1,0,1,0,16927,6.8,17720,201,48,773,-609,20.1,1692.7
4522805623,1,18,2,1,10,8,13,1,0,1,0,18426,7.2,18454,192,46,1493,202,19.2,1842.6,31,4,0,8,10,7,0,0,0,0,16933,7.0,18252,185,53,-1493,-202,18.5,1693.3
4511419534,0,15,4,1,7,7,9,0,0,0,0,16276,6.6,17546,215,40,273,-1195,21.5,1627.6,16,3,0,7,7,2,1,0,1,0,16003,7.2,18741,196,48,-273,1195,19.6,1600.3
4481808559,0,16,1,1,4,6,2,0,0,0,0,16463,7.2,18904,247,71,801,1090,24.7,1646.3,10,0,0,6,4,7,1,1,0,0,15662,6.8,17814,197,60,-801,-1090,19.7,1566.2
4495284570,1,17,4,0,7,5,10,1,1,0,0,17009,6.8,17881,222,40,1121,836,22.2,1700.9,15,4,1,5,7,4,0,0,0,0,15888,6.8,17045,228,52,-1121,-836,22.8,1588.8
4518870146,0,13,2,0,1,7,2,0,0,0,0,14490,7.0,17638,222,60,-2987,-2017,22.2,1449.0,14,4,1,7,1,10,1,1,0,0,17477,7.4,19655,235,56,2987,2017,23.5,1747.7
4525024153,1,17,2,0,8,8,5,0,0,0,0,17871,7.4,18848,243,52,1591,1901,24.3,1787.1,21,3,1,8,8,11,1,1,0,0,16280,6.6,16947,197,43,-1591,-1901,19.7,1628.0
4521042540,1,14,2,1,8,7,7,1,1,0,0,18271,7.4,19689,223,55,938,181,22.3,1827.1,10,1,0,7,8,6,1,0,1,0,17333,7.2,19508,204,52,-938,-181,20.4,1733.3
4487946743,0,15,2,0,7,5,8,1,1,0,0,17049,7.4,20151,223,68,-105,1881,22.3,1704.9,14,3,1,5,7,7,0,0,0,0,17154,7.2,18270,231,41,105,-1881,23.1,1715.4
4513579989,0,30,4,1,7,10,3,0,0,0,0,16399,7.0,18258,214,44,-1977,-944,21.4,1639.9,13,4,0,10,7,9,0,0,0,0,18376,7.2,19202,231,55,1977,944,23.1,1837.6
4522585401,1,15,5,0,9,4,7,0,0,0,0,17928,7.4,20419,250,60,2514,2924,25.0,1792.8,36,1,1,4,9,5,0,0,0,0,15414,7.0,17495,180,61,-2514,-2924,18.0,1541.4
4500845226,1,18,4,1,5,1,5,2,1,1,0,16951,7.2,18681,270,43,1341,-85,27.0,1695.1,77,4,0,1,5,1,0,0,0,0,15610,7.2,18766,254,76,-1341,85,25.4,1561.0
4523884002,0,17,0,0,1,7,2,0,0,0,0,13976,6.6,16595,211,48,-2971,-1923,21.1,1397.6,138,1,1,7,1,7,1,1,0,0,16947,7.2,18518,231,59,2971,1923,23.1,1694.7
4524765955,0,18,0,0,4,7,4,0,0,0,0,15362,6.2,15828,206,48,-1894,-2184,20.6,1536.2,13,2,1,7,4,4,1,0,1,1,17256,7.0,18012,196,52,1894,2184,19.6,1725.6
4520490742,0,20,4,1,5,8,7,1,1,0,0,14566,5.8,13119,164,37,-2663,-2578,16.4,1456.6,16,3,0,8,5,14,0,0,0,0,17229,6.6,15697,209,42,2663,2578,20.9,1722.9
4525381159,0,16,5,0,5,12,5,1,1,0,0,14819,6.8,16721,164,47,-4413,-3537,16.4,1481.9,39,7,1,12,5,8,0,0,0,0,19232,7.4,20258,242,42,4413,3537,24.2,1923.2
4480393322,1,17,2,1,8,3,10,1,1,0,0,17967,7.0,18074,240,43,3039,712,24.0,1796.7,17,2,0,3,8,3,0,0,0,0,14928,6.8,17362,211,53,-3039,-712,21.1,1492.8
4518410386,1,38,1,0,2,8,1,0,0,0,0,14141,6.6,16555,211,37,-2749,-800,21.1,1414.1,24,0,1,8,2,14,0,0,0,0,16890,6.8,17355,206,44,2749,800,20.6,1689.0
4520001049,1,42,2,1,9,6,10,1,1,0,0,18395,7.4,19262,242,45,2862,1862,24.2,1839.5,17,3,0,6,9,4,0,0,0,0,15533,6.8,17400,200,40,-2862,-1862,20.0,1553.3
4470854778,0,20,5,0,6,3,5,1,0,1,1,18017,7.2,18923,228,68,2459,834,22.8,1801.7,18,2,1,3,6,3,1,1,0,0,15558,6.8,18089,220,51,-2459,-834,22.0,1555.8
4522621799,1,13,3,0,8,5,6,2,1,1,1,18731,7.0,18165,225,48,2892,1413,22.5,1873.1,19,1,1,5,8,5,0,0,0,0,15839,6.4,16752,207,56,-2892,-1413,20.7,1583.9
4489141814,0,14,1,0,2,5,4,0,0,0,0,14743,6.8,17174,228,44,-1625,-2061,22.8,1474.3,21,3,1,5,2,8,2,1,1,0,16368,7.4,19235,239,60,1625,2061,23.9,1636.8
4455400959,1,35,3,1,8,3,13,0,0,0,0,17325,7.0,18380,217,26,3454,2249,21.7,1732.5,14,0,0,3,8,3,1,1,0,0,13871,6.8,16131,193,48,-3454,-2249,19.3,1387.1
4487965744,0,37,4,0,3,4,4,1,1,0,0,15306,6.8,16874,220,52,-961,-1427,22.0,1530.6,18,0,1,4,3,1,0,0,0,0,16267,7.2,18301,256,62,961,1427,25.6,1626.7
4525161056,1,40,4,0,6,4,11,0,0,0,0,16814,7.0,18612,238,56,2247,1262,23.8,1681.4,14,2,1,4,6,0,1,1,0,0,14567,6.8,17350,220,55,-2247,-1262,22.0,1456.7
4526528415,0,15,6,1,3,1,3,0,0,0,0,15392,7.0,17891,232,51,1232,114,23.2,1539.2,23,3,0,1,3,2,1,1,0,0,14160,6.8,17777,223,52,-1232,-114,22.3,1416.0
4517828246,1,17,3,0,6,8,4,1,1,0,0,16047,6.8,18407,214,58,-1495,330,21.4,1604.7,15,2,1,8,6,11,0,0,0,0,17542,6.8,18077,205,54,1495,-330,20.5,1754.2
4483768812,1,42,4,0,4,8,7,1,1,0,0,16220,6.8,17447,227,60,-444,-184,22.7,1622.0,58,8,1,8,4,12,0,0,0,0,16664,7.0,17631,212,46,444,184,21.2,1666.4
4512105521,0,16,4,0,9,6,9,1,1,0,0,17059,7.0,18302,214,52,977,1247,21.4,1705.9,16,1,1,6,9,5,0,0,0,0,16082,6.6,17055,203,52,-977,-1247,20.3,1608.2
4517167802,0,33,4,0,7,14,10,0,0,0,0,16204,7.0,17704,182,49,-4473,-3040,18.2,1620.4,17,1,1,14,7,19,1,1,0,0,20677,7.4,20744,237,80,4473,3040,23.7,2067.7
4518028905,0,16,2,1,8,9,5,0,0,0,0,16560,6.8,17640,200,47,-1611,-1380,20.0,1656.0,19,4,0,9,8,9,1,1,0,0,18171,7.2,19020,209,56,1611,1380,20.9,1817.1
4486656023,1,16,6,1,7,11,7,0,0,0,0,16851,6.8,16674,216,42,-778,-752,21.6,1685.1,13,4,0,11,7,14,1,1,0,0,17629,6.8,17426,200,34,778,752,20.0,1762.9
4524761713,1,22,0,0,6,4,5,1,1,0,0,16538,7.0,18735,227,44,1126,878,22.7,1653.8,12,1,1,4,6,2,1,0,1,0,15412,6.8,17857,225,45,-1126,-878,22.5,1541.2
4512514727,1,13,5,0,4,2,1,0,0,0,0,15555,7.2,19127,254,51,1019,1368,25.4,1555.5,23,1,1,2,4,2,1,1,0,0,14536,7.0,17759,217,60,-1019,-1368,21.7,1453.6
4524045722,1,33,2,1,9,4,8,1,0,1,0,18829,7.2,18693,233,52,4141,2833,23.3,1882.9,12,1,0,4,9,3,0,0,0,0,14688,6.6,15860,198,51,-4141,-2833,19.8,1468.8
4457019061,1,17,5,1,7,8,8,0,0,0,0,17363,6.8,17169,188,44,903,1019,18.8,1736.3,25,3,0,8,7,7,1,0,1,0,16460,6.4,16150,205,35,-903,-1019,20.5,1646.0
4496724887,1,23,5,1,8,2,13,1,1,0,0,17575,7.2,18579,228,52,2658,1915,22.8,1757.5,18,3,0,2,8,2,0,0,0,0,14917,6.6,16664,211,50,-2658,-1915,21.1,1491.7
4512278735,1,15,4,0,4,6,7,0,0,0,0,15634,7.2,18046,235,49,-1848,-617,23.5,1563.4,24,2,1,6,4,9,1,1,0,0,17482,7.2,18663,256,54,1848,617,25.6,1748.2
4509662137,1,14,0,0,5,8,6,0,0,0,0,15589,7.0,17960,203,43,-2111,-1385,20.3,1558.9,17,1,1,8,5,5,1,1,0,0,17700,7.2,19345,262,68,2111,1385,26.2,1770.0
4526116329,1,15,1,1,8,6,5,0,0,0,0,17693,7.0,18557,251,40,2501,2231,25.1,1769.3,15,1,0,6,8,7,0,0,0,0,15192,6.4,16326,176,52,-2501,-2231,17.6,1519.2
4519589584,0,18,1,1,4,2,3,0,0,0,0,15995,7.2,19023,220,72,500,64,22.0,1599.5,12,3,0,2,4,1,2,1,1,0,15495,7.0,18959,234,68,-500,-64,23.4,1549.5
4527420354,1,18,1,1,8,5,8,1,0,1,1,19558,7.6,20155,223,64,3438,2418,22.3,1955.8,50,4,0,5,8,4,1,1,0,0,16120,6.8,17737,197,60,-3438,-2418,19.7,1612.0
4492511838,1,15,3,1,10,3,8,1,0,1,0,17802,7.2,19007,222,34,3168,2910,22.2,1780.2,13,4,0,3,10,5,0,0,0,0,14634,6.6,16097,198,52,-3168,-2910,19.8,1463.4
4525188268,1,14,4,1,8,4,14,1,1,0,0,17451,6.8,17118,210,53,2470,1058,21.0,1745.1,14,1,0,4,8,3,0,0,0,0,14981,6.6,16060,219,30,-2470,-1058,21.9,1498.1
4491776589,1,19,1,0,4,10,3,0,0,0,0,14709,6.4,16206,209,29,-2923,-1079,20.9,1470.9,16,2,1,10,4,12,2,1,1,0,17632,6.8,17285,232,53,2923,1079,23.2,1763.2
4526160950,0,51,2,1,4,2,6,0,0,0,0,15236,6.8,17761,196,52,194,143,19.6,1523.6,15,2,0,2,4,3,1,1,0,0,15042,6.8,17618,254,48,-194,-143,25.4,1504.2
4519598858,0,84,0,0,6,14,5,0,0,0,0,15740,6.4,15862,177,49,-4093,-2844,17.7,1574.0,22,1,1,14,6,16,1,1,0,0,19833,7.2,18706,208,41,4093,2844,20.8,1983.3
4473903480,0,14,4,0,6,7,3,0,0,0,0,15827,6.6,17709,218,47,-1694,-603,21.8,1582.7,13,2,1,7,6,6,1,0,1,0,17521,7.0,18312,239,50,1694,603,23.9,1752.1
4518346455,1,13,3,1,6,2,9,0,0,0,0,16803,7.4,19509,242,44,1829,1496,24.2,1680.3,15,1,0,2,6,2,1,1,0,0,14974,7.0,18013,239,48,-1829,-1496,23.9,1497.4
4468111504,1,19,1,1,10,6,12,2,1,1,0,17706,7.0,18096,214,41,145,-1102,21.4,1770.6,9,3,0,6,10,8,0,0,0,0,17561,7.0,19198,221,64,-145,1102,22.1,1756.1
4484057160,1,19,2,0,7,5,12,2,1,1,0,18328,7.0,18180,223,57,3048,2219,22.3,1832.8,17,1,1,5,7,5,0,0,0,0,15280,6.6,15961,195,49,-3048,-2219,19.5,1528.0
4470635951,1,15,3,1,9,5,15,0,0,0,0,18721,7.2,19444,240,48,2411,1852,24.0,1872.1,14,4,0,5,9,6,1,1,0,0,16310,6.8,17592,219,58,-2411,-1852,21.9,1631.0
4513247424,1,22,3,1,6,7,4,0,0,0,0,16956,7.2,19155,242,61,-172,594,24.2,1695.6,17,3,0,7,6,10,1,1,0,0,17128,7.2,18561,213,61,172,-594,21.3,1712.8
4491128143,0,13,1,0,4,8,4,0,0,0,0,15676,7.2,19519,223,63,-2476,-394,22.3,1567.6,19,3,1,8,4,7,2,1,1,0,18152,7.4,19913,260,64,2476,394,26.0,1815.2
4487218004,1,37,4,1,10,7,11,0,0,0,0,18423,7.2,18773,212,40,2514,1424,21.2,1842.3,16,4,0,7,10,6,1,0,1,0,15909,6.8,17349,200,40,-2514,-1424,20.0,1590.9
4441887841,1,13,0,1,5,2,3,1,1,0,0,15397,6.8,18585,204,68,1516,709,20.4,1539.7,36,0,0,2,5,1,0,0,0,0,13881,7.0,17876,196,44,-1516,-709,19.6,1388.1
4502014751,0,36,0,1,4,8,3,0,0,0,0,14521,6.6,16346,186,40,-4413,-5071,18.6,1452.1,18,2,0,8,4,12,1,1,0,0,18934,7.8,21417,234,79,4413,5071,23.4,1893.4
4522469111,1,15,3,1,4,7,8,0,0,0,0,16002,6.6,16283,204,45,98,-786,20.4,1600.2,16,4,0,7,4,8,1,1,0,0,15904,6.6,17069,193,44,-98,786,19.3,1590.4
4519376202,1,14,2,1,5,3,4,1,1,0,0,15836,7.0,18174,223,44,813,487,22.3,1583.6,14,1,0,3,5,3,0,0,0,0,15023,6.8,17687,219,64,-813,-487,21.9,1502.3
4448321721,0,18,3,1,4,8,3,2,1,1,0,15815,7.2,18069,245,41,-1110,-391,24.5,1581.5,14,7,0,8,4,10,0,0,0,0,16925,7.0,18460,229,45,1110,391,22.9,1692.5
4483595782,1,16,7,1,8,6,9,0,0,0,0,18262,7.2,19248,224,58,2537,2412,22.4,1826.2,17,3,0,6,8,6,1,1,0,0,15725,6.6,16836,208,41,-2537,-2412,20.8,1572.5
4524511499,0,19,6,1,11,8,9,0,0,0,0,18475,7.4,19732,196,47,1761,1895,19.6,1847.5,19,3,0,8,11,9,1,1,0,0,16714,6.8,17837,196,52,-1761,-1895,19.6,1671.4
4497647239,1,13,1,1,8,6,8,2,1,1,1,18239,7.0,17409,199,46,2258,-819,19.9,1823.9,42,0,0,6,8,5,0,0,0,0,15981,7.0,18228,211,50,-2258,819,21.1,1598.1
4507704018,0,16,1,0,7,1,6,1,0,1,0,17820,7.6,20320,234,68,3462,2960,23.4,1782.0,10,0,1,1,7,1,1,1,0,0,14358,6.8,17360,205,60,-3462,-2960,20.5,1435.8
4477722271,1,35,1,0,4,4,5,0,0,0,0,16349,7.2,18699,253,62,754,13,25.3,1634.9,13,3,1,4,4,3,1,1,0,0,15595,7.2,18686,243,55,-754,-13,24.3,1559.5
4525614725,1,15,1,1,8,4,7,0,0,0,0,17972,7.4,19649,254,37,2455,2080,25.4,1797.2,14,0,0,4,8,3,0,0,0,0,15517,6.8,17569,214,57,-2455,-2080,21.4,1551.7
4504872920,0,15,2,1,5,3,6,0,0,0,0,16478,6.8,17590,254,44,1207,-488,25.4,1647.8,38,3,0,3,5,6,2,1,1,0,15271,7.2,18078,212,72,-1207,488,21.2,1527.1
4491140067,0,15,3,1,9,3,14,0,0,0,0,18017,7.0,18434,208,40,2917,930,20.8,1801.7,18,4,0,3,9,1,0,0,0,0,15100,6.8,17504,210,54,-2917,-930,21.0,1510.0
4447096755,1,22,4,1,6,4,5,2,1,1,0,16697,7.2,19170,236,59,852,1553,23.6,1669.7,17,3,0,4,6,7,0,0,0,0,15845,7.0,17617,214,51,-852,-1553,21.4,1584.5
4508073234,0,11,1,0,1,5,3,0,0,0,0,13686,6.8,16575,213,48,-2755,-2255,21.3,1368.6,17,0,1,5,1,4,2,1,1,0,16441,7.2,18830,230,59,2755,2255,23.0,1644.1
4522487692,1,14,3,0,3,6,4,0,0,0,0,15930,7.0,19263,241,71,-1240,-793,24.1,1593.0,14,4,1,6,3,6,1,1,0,0,17170,7.2,20056,252,64,1240,793,25.2,1717.0
4472901696,0,18,3,0,8,8,12,1,1,0,0,17388,6.6,16792,214,40,1327,-741,21.4,1738.8,17,4,1,8,8,6,0,0,0,0,16061,6.6,17533,190,47,-1327,741,19.0,1606.1
4482198928,0,50,1,0,9,11,8,1,1,0,0,17248,6.6,16433,185,40,-109,158,18.5,1724.8,13,3,1,11,9,6,0,0,0,0,17357,6.4,16275,195,33,109,-158,19.5,1735.7
4527662502,1,17,3,1,7,4,10,1,1,0,0,17197,7.2,18431,224,64,2348,1047,22.4,1719.7,19,2,0,4,7,4,0,0,0,0,14849,6.6,17384,206,49,-2348,-1047,20.6,1484.9
4450742884,0,14,3,0,4,2,5,1,0,1,0,16247,7.4,19687,226,72,1032,1098,22.6,1624.7,16,0,1,2,4,2,1,1,0,0,15215,7.0,18589,243,68,-1032,-1098,24.3,1521.5
4510973023,0,13,5,1,8,4,11,1,1,0,0,16357,6.6,17543,196,48,-82,280,19.6,1635.7,11,2,0,4,8,4,0,0,0,0,16439,6.8,17263,241,45,82,-280,24.1,1643.9
4497572230,0,17,5,0,3,10,3,0,0,0,0,14635,6.6,16718,202,41,-3709,-1017,20.2,1463.5,16,3,1,10,3,10,1,1,0,0,18344,6.8,17735,231,39,3709,1017,23.1,1834.4
4507022630,0,14,1,1,8,4,10,1,0,1,1,18913,7.4,19182,225,60,3240,1787,22.5,1891.3,19,4,0,4,8,6,1,1,0,0,15673,6.8,17395,237,48,-3240,-1787,23.7,1567.3
4519993636,0,16,3,0,7,5,10,0,0,0,0,16772,6.4,16548,228,42,192,-1496,22.8,1677.2,18,2,1,5,7,5,2,1,1,0,16580,6.8,18044,234,56,-192,1496,23.4,1658.0
4451957612,0,17,2,1,5,2,9,0,0,0,0,15429,6.8,16480,202,44,1043,-1408,20.2,1542.9,38,3,0,2,5,3,0,0,0,0,14386,6.8,17888,203,38,-1043,1408,20.3,1438.6
4498606360,0,19,4,0,4,3,7,1,1,0,0,14891,6.6,17103,210,44,-996,-1894,21.0,1489.1,16,2,1,3,4,3,0,0,0,0,15887,7.0,18997,261,60,996,1894,26.1,1588.7
4455149960,0,15,4,0,3,5,2,2,1,1,0,15073,6.8,16649,234,44,-745,-1826,23.4,1507.3,42,2,1,5,3,3,0,0,0,0,15818,7.0,18475,200,66,745,1826,20.0,1581.8
4519835303,0,14,3,0,0,5,0,0,0,0,0,13094,6.4,15865,205,44,-3915,-4094,20.5,1309.4,41,4,1,5,0,2,1,1,0,0,17009,7.4,19959,259,73,3915,4094,25.9,1700.9
4516748968,0,26,3,1,3,9,4,0,0,0,0,14280,6.2,15054,190,45,-3555,-3207,19.0,1428.0,15,1,0,9,3,10,1,1,0,0,17835,7.0,18261,220,43,3555,3207,22.0,1783.5
4498201124,1,14,3,1,6,3,6,0,0,0,0,17077,7.0,16964,228,44,2537,1396,22.8,1707.7,62,3,0,3,6,3,0,0,0,0,14540,6.0,15568,208,40,-2537,-1396,20.8,1454.0
4514842699,1,16,2,1,6,0,6,1,1,0,0,15318,7.0,17999,191,58,1125,299,19.1,1531.8,17,1,0,0,6,0,0,0,0,0,14193,7.0,17700,251,40,-1125,-299,25.1,1419.3
4470307479,0,18,2,1,5,4,4,0,0,0,0,15843,6.6,16776,220,42,792,-622,22.0,1584.3,16,3,0,4,5,4,0,0,0,0,15051,6.8,17398,185,49,-792,622,18.5,1505.1
4514249734,1,12,2,0,3,2,3,0,0,0,0,15484,6.8,18175,250,49,239,-709,25.0,1548.4,12,2,1,2,3,0,2,1,1,0,15245,7.2,18884,209,88,-239,709,20.9,1524.5
4519052446,1,36,7,1,10,6,11,2,1,1,0,18132,7.6,19522,232,47,1722,1514,23.2,1813.2,20,5,0,6,10,8,0,0,0,0,16410,7.2,18008,211,44,-1722,-1514,21.1,1641.0
4510930403,0,20,3,1,3,11,3,0,0,0,0,14731,6.6,16187,193,36,-3804,-2878,19.3,1473.1,43,5,0,11,3,17,1,1,0,0,18535,7.4,19065,217,44,3804,2878,21.7,1853.5
4515960899,0,15,1,1,11,3,13,1,1,0,0,18102,7.0,18787,216,56,1712,1178,21.6,1810.2,15,2,0,3,11,1,1,0,1,1,16390,6.8,17609,226,36,-1712,-1178,22.6,1639.0
4522356055,1,19,2,0,6,5,5,1,1,0,0,15926,6.8,17186,209,44,905,1369,20.9,1592.6,15,2,1,5,6,10,0,0,0,0,15021,6.4,15817,180,40,-905,-1369,18.0,1502.1
4505476862,1,33,3,1,9,3,9,0,0,0,0,18205,7.4,19871,225,48,4061,3186,22.5,1820.5,12,0,0,3,9,2,1,0,1,0,14144,6.6,16685,187,39,-4061,-3186,18.7,1414.4
4522534575,1,15,2,1,5,6,5,1,1,0,0,15536,6.8,17751,179,52,-833,-1021,17.9,1553.6,13,2,0,6,5,6,1,0,1,0,16369,7.2,18772,240,60,833,1021,24.0,1636.9
4526583162,1,16,4,1,9,3,13,1,1,0,0,19186,7.2,19737,261,52,4331,3427,26.1,1918.6,14,2,0,3,9,4,0,0,0,0,14855,6.4,16310,199,48,-4331,-3427,19.9,1485.5
4387767645,1,16,1,1,10,7,9,1,1,0,1,19018,7.2,19294,209,63,3126,3795,20.9,1901.8,12,1,0,7,10,11,0,0,0,0,15892,6.4,15499,162,51,-3126,-3795,16.2,1589.2
4495582337,1,10,2,0,9,1,13,1,0,1,0,17329,7.0,18182,189,56,2252,1086,18.9,1732.9,16,3,1,1,9,2,0,0,0,0,15077,7.0,17096,244,58,-2252,-1086,24.4,1507.7
4439348607,0,19,5,0,7,11,11,1,1,0,0,16187,6.4,16701,216,30,-2377,-2355,21.6,1618.7,20,0,1,11,7,14,0,0,0,0,18564,7.0,19056,206,67,2377,2355,20.6,1856.4
4469976070,1,14,2,1,7,6,8,1,1,0,0,15632,6.2,15789,196,32,-1339,-2802,19.6,1563.2,17,2,0,6,7,8,1,0,1,0,16971,7.0,18591,216,67,1339,2802,21.6,1697.1
4525993420,1,26,1,1,6,6,7,1,0,1,1,17312,6.6,16818,209,50,1139,-885,20.9,1731.2,17,2,0,6,6,8,1,1,0,0,16173,6.8,17703,208,52,-1139,885,20.8,1617.3
4519160523,1,41,4,1,8,9,10,1,1,0,0,16076,6.2,14942,181,42,143,-603,18.1,1607.6,12,0,0,9,8,18,0,0,0,0,15933,6.4,15545,178,32,-143,603,17.8,1593.3
4524509004,1,16,2,0,3,5,3,0,0,0,0,15366,7.0,17861,230,55,-1364,-87,23.0,1536.6,15,2,1,5,3,7,1,1,0,0,16730,6.8,17948,243,40,1364,87,24.3,1673.0
4510669887,1,39,3,0,1,2,0,1,1,0,0,14645,7.2,18690,256,52,-1377,-180,25.6,1464.5,49,3,1,2,1,2,1,0,1,0,16022,7.2,18870,289,56,1377,180,28.9,1602.2
4523645725,1,15,3,0,3,6,3,0,0,0,0,15736,6.8,18798,232,72,-259,555,23.2,1573.6,15,2,1,6,3,5,2,1,1,0,15995,6.8,18243,220,48,259,-555,22.0,1599.5
4509363345,0,40,2,1,6,8,9,0,0,0,0,16185,6.8,17924,204,40,-2100,-925,20.4,1618.5,14,20,0,8,6,12,2,1,1,1,18285,7.0,18849,199,40,2100,925,19.9,1828.5
4496336635,1,35,2,1,3,6,5,0,0,0,0,14703,6.8,16970,198,36,-2127,-1619,19.8,1470.3,18,2,0,6,3,10,1,1,0,0,16830,7.0,18589,233,55,2127,1619,23.3,1683.0
4519577076,0,19,3,0,8,12,12,0,0,0,0,18501,6.8,17881,207,60,-939,-2597,20.7,1850.1,74,2,1,12,8,15,1,1,0,0,19440,7.2,20478,214,52,939,2597,21.4,1944.0
4423246769,0,12,2,1,7,8,5,1,1,0,0,15810,6.6,16837,193,48,-1305,-2023,19.3,1581.0,12,0,0,8,7,5,0,0,0,1,17115,7.2,18860,189,62,1305,2023,18.9,1711.5
4511791303,1,15,1,1,5,3,2,1,1,0,0,16421,7.0,18152,241,48,1239,-1051,24.1,1642.1,42,1,0,3,5,2,0,0,0,0,15182,7.2,19203,219,73,-1239,1051,21.9,1518.2
4450399741,0,21,5,1,8,6,10,0,0,0,0,17136,7.0,18233,202,54,1363,-147,20.2,1713.6,18,5,0,6,8,2,1,0,1,0,15773,7.0,18380,218,56,-1363,147,21.8,1577.3
4486524151,0,21,1,1,5,7,4,0,0,0,0,16218,6.8,16863,204,52,-193,-634,20.4,1621.8,18,2,0,7,5,10,2,1,1,0,16411,6.8,17497,202,48,193,634,20.2,1641.1
4461378771,1,16,2,1,11,10,8,1,0,1,0,18762,7.0,18724,202,40,1378,1187,20.2,1876.2,15,2,0,10,11,6,0,0,0,0,17384,7.0,17537,212,52,-1378,-1187,21.2,1738.4
4517762316,1,16,3,1,6,7,3,0,0,0,0,16241,7.2,18124,238,47,-602,-905,23.8,1624.1,16,3,0,7,6,5,0,0,0,0,16843,7.2,19029,232,68,602,905,23.2,1684.3
4474862370,0,28,6,0,8,8,8,1,1,0,0,16601,6.2,16246,196,44,103,63,19.6,1660.1,81,3,1,8,8,6,0,0,0,0,16498,6.4,16183,194,46,-103,-63,19.4,1649.8
4485840157,0,14,1,1,6,8,5,0,0,0,0,16892,7.0,18225,226,48,-44,277,22.6,1689.2,14,1,0,8,6,10,1,1,0,0,16936,7.0,17948,185,48,44,-277,18.5,1693.6
4522604950,0,14,3,1,9,14,11,0,0,0,0,17496,6.8,17522,185,51,-2574,-2554,18.5,1749.6,15,2,0,14,9,13,1,1,0,0,20070,7.4,20076,198,56,2574,2554,19.8,2007.0
4384417283,1,19,2,0,10,3,13,1,1,0,0,17951,7.2,18502,226,44,3022,2631,22.6,1795.1,13,4,1,3,10,5,0,0,0,0,14929,6.6,15871,209,44,-3022,-2631,20.9,1492.9
4514536242,0,46,2,0,4,5,5,0,0,0,0,14511,6.2,17013,193,52,-2246,-961,19.3,1451.1,20,4,1,5,4,7,1,1,0,0,16757,7.0,17974,233,44,2246,961,23.3,1675.7
4423079773,1,16,4,1,6,4,8,2,1,1,0,16832,7.2,18675,221,65,1624,1008,22.1,1683.2,17,1,0,4,6,5,0,0,0,0,15208,7.0,17667,238,33,-1624,-1008,23.8,1520.8
4515507171,1,14,3,0,5,5,4,1,1,0,0,16313,7.0,18652,242,47,-152,-537,24.2,1631.3,18,4,1,5,5,5,0,0,0,0,16465,7.2,19189,213,64,152,537,21.3,1646.5
4524969283,0,15,1,1,6,6,10,0,0,0,0,16260,6.8,17516,205,59,-402,-520,20.5,1626.0,18,2,0,6,6,7,1,0,1,0,16662,7.0,18036,219,51,402,520,21.9,1666.2
4527053268,1,41,5,1,8,6,12,0,0,0,0,18675,7.6,20603,219,61,2125,2034,21.9,1867.5,15,2,0,6,8,5,1,1,0,0,16550,7.0,18569,222,64,-2125,-2034,22.2,1655.0
4525860458,1,44,3,1,6,2,7,0,0,0,0,17311,7.0,18763,257,52,2781,1229,25.7,1731.1,13,15,0,2,6,2,0,0,0,0,14530,6.8,17534,216,60,-2781,-1229,21.6,1453.0
4518326207,1,15,2,0,11,4,11,0,0,0,0,18470,7.4,19952,231,59,3418,3608,23.1,1847.0,37,0,1,4,11,3,0,0,0,0,15052,6.4,16344,214,36,-3418,-3608,21.4,1505.2
4520567149,0,20,3,1,9,8,11,1,1,0,0,17429,6.8,17309,211,48,720,-183,21.1,1742.9,16,4,0,8,9,10,0,0,0,0,16709,6.8,17492,210,50,-720,183,21.0,1670.9
4526011384,0,35,3,0,0,11,0,0,0,0,0,13590,6.6,16558,200,49,-5691,-3094,20.0,1359.0,13,3,1,11,0,11,1,1,0,0,19281,7.4,19652,220,52,5691,3094,22.0,1928.1
4518444031,0,16,5,1,10,8,12,1,1,0,0,17357,7.0,18388,191,59,-310,570,19.1,1735.7,27,2,0,8,10,9,1,0,1,0,17667,7.2,17818,194,56,310,-570,19.4,1766.7
4520773672,0,19,3,1,13,4,17,0,0,0,0,19145,7.2,19160,218,40,4947,3211,21.8,1914.5,15,4,0,4,13,2,1,1,0,0,14198,6.2,15949,203,36,-4947,-3211,20.3,1419.8
4457833778,1,17,1,1,5,6,5,0,0,0,0,16781,6.8,18303,222,48,679,1400,22.2,1678.1,17,0,0,6,5,6,1,1,0,0,16102,6.6,16903,192,57,-679,-1400,19.2,1610.2
4519646184,1,13,2,0,4,4,6,0,0,0,0,15800,7.4,19395,231,72,-302,764,23.1,1580.0,10,5,1,4,4,4,0,0,0,0,16102,7.2,18631,236,49,302,-764,23.6,1610.2
4518160396,1,12,3,1,3,5,4,1,1,0,0,14323,6.6,16834,184,55,-2546,-2542,18.4,1432.3,14,3,0,5,3,5,1,0,1,0,16869,7.6,19376,243,70,2546,2542,24.3,1686.9
4452157467,1,27,6,0,5,6,10,1,1,0,0,15853,7.0,17700,204,55,-153,-962,20.4,1585.3,20,5,1,6,5,4,0,0,0,0,16006,6.8,18662,241,44,153,962,24.1,1600.6
4525303042,0,17,0,1,8,9,8,0,0,0,0,16640,6.6,16726,222,43,-1939,-2911,22.2,1664.0,14,1,0,9,8,15,2,1,1,0,18579,7.4,19637,233,56,1939,2911,23.3,1857.9
4462552916,0,16,2,0,2,3,1,0,0,0,0,13581,7.0,17687,201,46,-1885,-366,20.1,1358.1,25,4,1,3,2,5,1,1,0,0,15466,7.2,18053,246,54,1885,366,24.6,1546.6
4526974139,0,13,1,1,7,7,9,0,0,0,0,16956,7.0,18267,229,28,399,1148,22.9,1695.6,15,1,0,7,7,12,2,1,1,0,16557,6.8,17119,187,55,-399,-1148,18.7,1655.7
4507851254,1,52,2,0,6,5,12,0,0,0,1,17107,6.8,17665,215,43,-1661,-1259,21.5,1710.7,19,3,1,5,6,4,2,1,1,2,18768,7.0,18924,239,71,1661,1259,23.9,1876.8
4518881897,1,16,1,1,7,6,5,0,0,0,0,16345,6.6,16530,204,47,-323,-992,20.4,1634.5,54,2,0,6,7,8,1,1,0,0,16668,7.0,17522,190,56,323,992,19.0,1666.8
4479856862,1,19,5,1,7,7,8,1,1,0,0,16282,6.8,16565,211,44,686,-89,21.1,1628.2,55,3,0,7,7,6,1,0,1,0,15596,6.6,16654,180,51,-686,89,18.0,1559.6
4460927725,1,16,3,1,13,1,15,1,1,0,2,22177,7.8,21202,230,58,8450,6098,23.0,2217.7,19,2,0,1,13,2,1,0,1,0,13727,6.2,15104,201,48,-8450,-6098,20.1,1372.7
4517493567,0,15,5,1,4,3,4,0,0,0,0,15267,6.6,17321,232,53,453,-19,23.2,1526.7,16,2,0,3,4,3,0,0,0,0,14814,6.8,17340,209,51,-453,19,20.9,1481.4
4458628043,1,16,2,1,6,3,6,1,1,0,0,16847,7.4,19065,220,67,2341,2303,22.0,1684.7,14,4,0,3,6,3,0,0,0,0,14506,6.6,16762,214,38,-2341,-2303,21.4,1450.6
4441403793,0,18,2,1,6,2,7,0,0,0,0,17083,7.2,19485,241,60,2263,1666,24.1,1708.3,24,5,0,2,6,1,1,1,0,0,14820,7.0,17819,250,48,-2263,-1666,25.0,1482.0
4477479713,1,17,1,1,10,3,8,1,1,0,0,18463,7.4,19599,248,40,3002,2125,24.8,1846.3,10,2,0,3,10,3,1,0,1,0,15461,6.8,17474,218,58,-3002,-2125,21.8,1546.1
4462682935,0,25,1,1,5,5,8,0,0,0,0,14966,6.4,16483,177,45,-1470,-1837,17.7,1496.6,17,5,0,5,5,10,1,1,0,0,16436,7.0,18320,220,59,1470,1837,22.0,1643.6
4517995576,0,37,2,1,6,5,5,1,0,1,0,16490,6.8,17576,225,48,-508,-1394,22.5,1649.0,15,2,0,5,6,3,1,1,0,0,16998,7.2,18970,257,72,508,1394,25.7,1699.8
4484788416,1,39,2,0,7,7,9,0,0,0,0,16391,7.0,17955,209,39,129,230,20.9,1639.1,35,2,1,7,7,5,1,1,0,0,16262,6.6,17725,199,63,-129,-230,19.9,1626.2
4487526235,1,17,1,0,4,5,4,0,0,0,0,16194,6.8,17871,238,76,376,-194,23.8,1619.4,19,4,1,5,4,10,2,1,1,0,15818,7.0,18065,215,52,-376,194,21.5,1581.8
4463020828,1,22,3,0,12,6,17,0,0,0,0,17875,6.8,17882,205,31,1880,1473,20.5,1787.5,15,1,1,6,12,3,0,0,0,0,15995,6.4,16409,190,57,-1880,-1473,19.0,1599.5
4462322651,1,12,6,0,2,6,2,2,1,1,0,15386,7.2,18832,246,60,-1402,-1003,24.6,1538.6,15,0,1,6,2,4,0,0,0,0,16788,7.6,19835,264,51,1402,1003,26.4,1678.8
4526183369,1,22,4,1,10,8,17,1,1,0,0,18828,7.2,18186,197,53,2117,180,19.7,1882.8,16,4,0,8,10,8,1,0,1,0,16711,6.8,18006,209,47,-2117,-180,20.9,1671.1
4506831821,0,15,2,1,2,12,3,0,0,0,0,14379,6.6,16423,203,49,-6676,-3924,20.3,1437.9,12,5,0,12,2,14,1,1,0,1,21055,7.2,20347,223,66,6676,3924,22.3,2105.5
4512231954,0,19,2,0,5,6,2,2,1,1,0,15975,6.6,17545,222,60,-33,-559,22.2,1597.5,12,2,1,6,5,7,0,0,0,0,16008,7.0,18104,214,55,33,559,21.4,1600.8
4527144982,1,51,4,1,7,5,7,0,0,0,0,17549,7.4,19400,239,54,2588,1353,23.9,1754.9,13,1,0,5,7,6,0,0,0,0,14961,6.6,18047,192,50,-2588,-1353,19.2,1496.1
4455235066,1,15,1,1,13,5,10,0,0,0,0,19485,7.4,19900,196,58,3823,2563,19.6,1948.5,12,2,0,5,13,5,0,0,0,0,15662,6.6,17337,201,44,-3823,-2563,20.1,1566.2
4521050859,1,21,2,0,3,4,1,0,0,0,0,14202,6.8,16773,212,37,-2263,-1397,21.2,1420.2,14,6,1,4,3,4,1,1,0,0,16465,6.8,18170,240,60,2263,1397,24.0,1646.5
4519045200,0,13,2,0,7,7,6,0,0,0,0,17064,7.0,18061,236,48,134,-396,23.6,1706.4,15,2,1,7,7,8,1,1,0,0,16930,7.0,18457,210,59,-134,396,21.0,1693.0
4510352485,0,14,2,1,6,0,7,0,0,0,0,17476,7.2,19471,226,68,3460,2275,22.6,1747.6,17,2,0,0,6,0,1,1,0,0,14016,6.8,17196,242,64,-3460,-2275,24.2,1401.6
4497972211,1,16,4,0,4,3,5,0,0,0,0,15429,7.0,18085,238,41,39,-301,23.8,1542.9,15,3,1,3,4,2,1,1,0,0,15390,7.0,18386,238,60,-39,301,23.8,1539.0
4509431261,1,47,0,1,5,3,7,0,0,0,0,16329,6.8,17600,205,48,1320,-178,20.5,1632.9,12,3,0,3,5,4,0,0,0,0,15009,6.8,17778,218,48,-1320,178,21.8,1500.9
4488915308,0,16,8,0,4,11,9,0,0,0,0,15124,6.8,17488,213,37,-4664,-2707,21.3,1512.4,22,2,1,11,4,7,2,1,1,0,19788,7.4,20195,249,66,4664,2707,24.9,1978.8
4432336301,0,18,3,1,2,7,1,0,0,0,0,14639,6.6,16690,222,40,-2862,-3209,22.2,1463.9,16,4,0,7,2,12,1,1,0,0,17501,7.6,19899,237,62,2862,3209,23.7,1750.1
4511649703,1,62,2,1,6,1,8,2,1,1,0,16601,7.0,18535,231,44,1799,442,23.1,1660.1,15,0,0,1,6,1,0,0,0,0,14802,6.8,18093,231,72,-1799,-442,23.1,1480.2
4515211180,1,15,2,1,5,4,1,2,1,1,0,15917,7.0,18370,211,64,805,691,21.1,1591.7,13,3,0,4,5,4,0,0,0,0,15112,6.8,17679,187,60,-805,-691,18.7,1511.2
4526832439,1,17,1,0,6,6,6,1,1,0,0,17476,7.0,18428,219,63,1408,957,21.9,1747.6,17,2,1,6,6,6,0,0,0,0,16068,6.8,17471,231,44,-1408,-957,23.1,1606.8
4445701647,1,74,3,0,10,7,9,1,0,1,0,18209,7.2,18851,209,50,2343,2878,20.9,1820.9,17,3,1,7,10,8,1,1,0,0,15866,6.4,15973,170,54,-2343,-2878,17.0,1586.6
4499972378,0,39,4,0,1,5,2,1,1,0,0,14032,6.4,16940,220,53,-1935,-1534,22.0,1403.2,15,3,1,5,1,5,0,0,0,0,15967,7.2,18474,231,45,1935,1534,23.1,1596.7
4496489619,0,38,4,0,0,3,0,1,0,1,0,13793,6.8,17022,223,58,-2240,-1623,22.3,1379.3,14,2,1,3,0,1,1,1,0,0,16033,7.0,18645,247,59,2240,1623,24.7,1603.3
4499958470,1,12,3,1,8,7,7,1,1,0,0,16972,7.0,18007,184,44,891,1054,18.4,1697.2,14,1,0,7,8,7,0,0,0,0,16081,6.6,16953,196,51,-891,-1054,19.6,1608.1
4503636905,0,43,3,0,3,7,3,1,0,1,0,14852,6.8,16888,203,54,-1975,-1345,20.3,1485.2,17,14,1,7,3,6,0,0,0,0,16827,6.8,18233,218,53,1975,1345,21.8,1682.7
4524179867,0,11,5,0,6,12,8,0,0,0,0,15211,6.4,16421,187,47,-3746,-3014,18.7,1521.1,20,3,1,12,6,18,1,1,0,0,18957,7.2,19435,230,56,3746,3014,23.0,1895.7
4526069179,0,15,2,1,6,6,7,1,1,0,0,16148,6.8,15943,200,45,-1106,-1434,20.0,1614.8,15,2,0,6,6,9,1,0,1,0,17254,6.6,17377,216,70,1106,1434,21.6,1725.4
4494864543,0,18,2,0,8,5,6,0,0,0,0,16237,6.8,17830,209,48,335,675,20.9,1623.7,16,1,1,5,8,5,1,1,0,0,15902,6.8,17155,192,64,-335,-675,19.2,1590.2
4523728441,1,7,0,1,9,11,10,1,1,0,0,18601,7.0,18627,220,63,1939,166,22.0,1860.1,13,1,0,11,9,7,0,0,0,0,16662,7.0,18461,174,44,-1939,-166,17.4,1666.2
4515955272,1,16,11,0,9,7,5,0,0,0,0,18451,7.4,19111,226,60,1309,657,22.6,1845.1,43,2,1,7,9,5,0,0,0,0,17142,6.8,18454,206,44,-1309,-657,20.6,1714.2
4469156590,0,14,0,1,8,13,8,1,1,0,0,16797,6.8,17770,200,48,-3201,-3067,20.0,1679.7,55,1,0,13,8,16,0,0,0,0,19998,7.6,20837,232,47,3201,3067,23.2,1999.8
4524502451,1,16,3,1,4,4,3,1,1,0,0,15620,7.0,17974,225,52,234,-318,22.5,1562.0,89,2,0,4,4,4,0,0,0,0,15386,7.0,18292,227,40,-234,318,22.7,1538.6
4496972766,0,15,3,0,6,7,8,0,0,0,0,16564,7.0,18202,213,49,-443,-447,21.3,1656.4,14,2,1,7,6,4,0,0,0,0,17007,7.0,18649,216,46,443,447,21.6,1700.7
4507859079,1,18,2,1,4,4,4,0,0,0,0,15760,7.0,18295,215,48,-137,-351,21.5,1576.0,15,1,0,4,4,1,1,1,0,0,15897,7.0,18646,227,72,137,351,22.7,1589.7
4481779258,0,40,1,1,5,6,4,0,0,0,0,15815,6.8,17429,224,40,-721,-1118,22.4,1581.5,12,2,0,6,5,7,1,1,0,0,16536,7.0,18547,241,50,721,1118,24.1,1653.6
4524566324,0,23,1,0,8,9,8,1,0,1,0,17380,7.2,18665,220,60,-213,399,22.0,1738.0,14,1,1,9,8,14,0,0,0,0,17593,7.0,18266,215,36,213,-399,21.5,1759.3
4520933584,1,17,6,0,7,3,7,0,0,0,0,16849,7.0,18439,231,44,1991,1977,23.1,1684.9,16,3,1,3,7,3,1,1,0,0,14858,6.4,16462,223,49,-1991,-1977,22.3,1485.8
4473558954,0,16,1,0,5,5,3,0,0,0,0,15153,7.2,18629,191,51,-809,411,19.1,1515.3,15,1,1,5,5,5,1,1,0,0,15962,7.0,18218,216,44,809,-411,21.6,1596.2
4412946059,1,18,5,1,6,3,4,0,0,0,0,16876,7.0,18664,256,44,2717,2815,25.6,1687.6,17,4,0,3,6,4,0,0,0,0,14159,6.4,15849,205,43,-2717,-2815,20.5,1415.9
4456030501,1,15,1,1,9,4,11,1,0,1,0,17495,7.0,19239,235,44,1858,1429,23.5,1749.5,38,1,0,4,9,3,1,1,0,0,15637,6.8,17810,215,52,-1858,-1429,21.5,1563.7
4515904262,1,17,1,0,8,7,7,0,0,0,0,17908,7.2,19202,229,54,653,430,22.9,1790.8,12,2,1,7,8,9,1,1,0,0,17255,7.2,18772,247,46,-653,-430,24.7,1725.5
4456827660,1,17,3,1,8,5,13,1,1,0,0,17355,6.8,17548,204,39,1890,1473,20.4,1735.5,70,3,0,5,8,5,0,0,0,0,15465,6.4,16075,177,48,-1890,-1473,17.7,1546.5
4515233268,1,14,4,1,7,7,7,2,1,1,0,17381,7.2,20017,221,76,1542,2179,22.1,1738.1,17,2,0,7,7,4,0,0,0,0,15839,7.0,17838,204,48,-1542,-2179,20.4,1583.9
4494818793,0,16,2,0,6,8,3,0,0,0,0,15334,6.4,16172,203,44,-1343,-768,20.3,1533.4,21,3,1,8,6,5,1,1,0,0,16677,6.6,16940,204,36,1343,768,20.4,1667.7
4492190443,1,16,2,1,6,4,11,0,0,0,0,16731,7.0,17558,239,49,2073,2090,23.9,1673.1,15,4,0,4,6,4,0,0,0,0,14658,6.4,15468,203,38,-2073,-2090,20.3,1465.8
4511647215,0,13,3,0,5,7,8,1,0,1,0,15457,6.6,17048,191,58,-1647,-3035,19.1,1545.7,13,4,1,7,5,7,1,1,0,0,17104,7.4,20083,251,54,1647,3035,25.1,1710.4
4507304964,0,16,2,1,5,9,3,1,1,0,0,16182,7.0,17560,204,46,-320,-120,20.4,1618.2,17,0,0,9,5,11,0,0,0,0,16502,7.0,17680,195,36,320,120,19.5,1650.2
4413539086,1,23,4,1,11,9,12,1,0,1,1,19858,7.4,19501,216,54,3335,2786,21.6,1985.8,17,3,0,9,11,12,1,1,0,0,16523,6.4,16715,168,46,-3335,-2786,16.8,1652.3
4525092845,0,16,1,1,5,10,3,1,0,1,0,16141,7.0,17238,229,52,-1634,-2844,22.9,1614.1,14,3,0,10,5,10,0,0,0,0,17775,7.6,20082,240,40,1634,2844,24.0,1777.5
4491456543,1,20,5,1,10,1,15,1,1,0,0,18795,7.4,20241,260,43,4498,3370,26.0,1879.5,22,3,0,1,10,2,0,0,0,0,14297,6.4,16871,226,48,-4498,-3370,22.6,1429.7
4517823800,0,19,5,1,6,7,7,0,0,0,0,16072,6.6,17054,225,46,-420,-1185,22.5,1607.2,15,3,0,7,6,10,1,1,0,0,16492,7.2,18239,212,50,420,1185,21.2,1649.2
4462513119,0,43,2,0,5,7,5,1,1,0,0,16028,7.0,18310,216,65,-1437,-770,21.6,1602.8,12,22,1,7,5,9,0,0,0,0,17465,7.0,19080,259,48,1437,770,25.9,1746.5
4476670198,1,17,3,0,3,8,3,1,1,0,0,14591,6.8,16795,224,46,-3236,-2874,22.4,1459.1,16,3,1,8,3,8,1,0,1,0,17827,7.4,19669,252,50,3236,2874,25.2,1782.7
4527590417,0,12,2,0,4,10,3,0,0,0,0,15690,6.8,18165,223,40,-2802,-1606,22.3,1569.0,17,3,1,10,4,16,2,1,1,0,18492,7.4,19771,227,44,2802,1606,22.7,1849.2
4475394181,0,18,2,1,6,5,2,1,1,0,0,15531,7.0,17915,192,52,-537,176,19.2,1553.1,20,3,0,5,6,5,0,0,0,0,16068,6.8,17739,198,64,537,-176,19.8,1606.8
4515382430,1,23,5,0,5,8,7,1,0,1,0,16250,6.8,17847,233,52,-964,-202,23.3,1625.0,22,4,1,8,5,7,1,1,0,0,17214,6.8,18049,221,44,964,202,22.1,1721.4
4524709324,1,16,1,1,5,6,5,1,1,0,0,15706,6.6,17219,228,43,-469,-1237,22.8,1570.6,19,5,0,6,5,4,0,0,0,0,16175,7.0,18456,229,56,469,1237,22.9,1617.5
4520554250,0,21,5,0,7,7,4,0,0,0,0,17319,7.0,18310,253,36,2209,1640,25.3,1731.9,14,6,1,7,7,6,2,1,1,0,15110,6.8,16670,159,49,-2209,-1640,15.9,1511.0
4438396733,1,17,3,1,12,5,14,1,1,0,0,18499,7.0,17823,210,36,3473,2812,21.0,1849.9,15,1,0,5,12,6,0,0,0,0,15026,6.2,15011,204,20,-3473,-2812,20.4,1502.6
4523386902,0,20,0,0,6,13,8,0,0,0,0,15304,6.4,15933,175,40,-5191,-3819,17.5,1530.4,13,4,1,13,6,15,0,0,0,0,20495,7.2,19752,229,49,5191,3819,22.9,2049.5
4519004936,0,11,0,1,5,9,2,0,0,0,0,14681,6.8,17137,174,44,-2985,-3019,17.4,1468.1,9,0,0,9,5,8,1,1,0,0,17666,7.6,20156,213,55,2985,3019,21.3,1766.6
4485213247,0,17,8,0,7,8,8,0,0,0,0,16670,7.0,17287,220,42,-508,-1385,22.0,1667.0,20,3,1,8,7,6,0,0,0,0,17178,7.0,18672,217,54,508,1385,21.7,1717.8
4490435808,0,13,5,1,5,5,8,1,0,1,0,16009,6.8,18033,220,40,540,269,22.0,1600.9,15,2,0,5,5,8,1,1,0,0,15469,6.8,17764,185,54,-540,-269,18.5,1546.9
4465123889,1,16,3,0,8,11,11,0,0,0,0,17554,6.6,16706,227,43,-1548,-1988,22.7,1755.4,20,7,1,11,8,13,2,1,1,0,19102,7.0,18694,225,58,1548,1988,22.5,1910.2
4523108166,0,18,4,1,8,8,12,1,1,0,0,16171,6.6,16898,214,43,-1642,-2040,21.4,1617.1,16,4,0,8,8,9,1,0,1,0,17813,7.2,18938,235,60,1642,2040,23.5,1781.3
4524963317,1,73,0,1,10,3,8,0,0,0,0,18130,7.0,18640,216,41,3905,1506,21.6,1813.0,23,1,0,3,10,3,1,1,0,0,14225,6.8,17134,173,56,-3905,-1506,17.3,1422.5
4526360728,0,13,6,0,4,7,2,0,0,0,0,15188,6.8,17740,194,69,-1269,-1991,19.4,1518.8,19,2,1,7,4,5,1,0,1,0,16457,7.2,19731,213,67,1269,1991,21.3,1645.7
4509036476,0,10,3,0,0,5,0,0,0,0,0,12905,6.2,15457,195,44,-3927,-3257,19.5,1290.5,17,3,1,5,0,5,0,0,0,0,16832,7.0,18714,211,78,3927,3257,21.1,1683.2
4521779426,1,13,2,1,7,5,12,1,1,0,0,17042,7.0,18045,223,60,1004,559,22.3,1704.2,12,2,0,5,7,9,0,0,0,0,16038,6.8,17486,182,48,-1004,-559,18.2,1603.8
4499619236,0,44,1,0,7,12,12,1,0,1,0,16548,6.8,17321,192,56,-2775,-2872,19.2,1654.8,28,1,1,12,7,10,1,1,0,0,19323,7.4,20193,220,45,2775,2872,22.0,1932.3
4462053838,0,17,3,0,7,6,8,0,0,0,0,16441,6.4,16272,218,42,132,-2613,21.8,1644.1,39,5,1,6,7,6,1,1,0,0,16309,7.0,18885,203,69,-132,2613,20.3,1630.9
4484124501,1,15,2,1,6,3,5,1,1,0,0,16523,7.0,18465,238,43,1284,1445,23.8,1652.3,15,5,0,3,6,2,0,0,0,0,15239,6.8,17020,239,56,-1284,-1445,23.9,1523.9
4519057052,0,51,2,1,4,4,5,1,1,0,0,15059,6.8,17260,196,60,-345,-715,19.6,1505.9,36,11,0,4,4,2,0,0,0,0,15404,6.6,17975,237,52,345,715,23.7,1540.4
4519740782,1,18,1,1,6,3,5,2,1,1,0,17119,7.2,18962,233,57,2031,1967,23.3,1711.9,16,1,0,3,6,3,0,0,0,0,15088,6.8,16995,209,52,-2031,-1967,20.9,1508.8
4525540898,1,15,1,1,6,3,7,1,0,1,0,16421,6.4,16972,207,52,936,-497,20.7,1642.1,38,4,0,3,6,3,1,1,0,0,15485,7.2,17469,231,60,-936,497,23.1,1548.5
4512993311,0,16,1,0,4,12,3,0,0,0,0,15335,6.4,16838,187,71,-3983,-3676,18.7,1533.5,39,1,1,12,4,9,0,0,0,0,19318,7.4,20514,242,45,3983,3676,24.2,1931.8
4462148925,1,17,2,1,4,3,10,1,1,0,0,15730,7.0,18484,241,52,739,-270,24.1,1573.0,16,2,0,3,4,5,0,0,0,0,14991,7.0,18754,239,59,-739,270,23.9,1499.1
4527613932,0,12,2,1,6,3,5,0,0,0,0,16007,6.8,17907,221,40,1201,695,22.1,1600.7,12,0,0,3,6,3,1,1,0,0,14806,6.8,17212,209,40,-1201,-695,20.9,1480.6
4522686444,0,16,1,1,6,5,4,0,0,0,0,16682,7.0,18272,236,52,598,374,23.6,1668.2,14,4,0,5,6,5,1,1,0,0,16084,6.8,17898,235,60,-598,-374,23.5,1608.4
4514010744,1,13,4,1,4,2,3,1,1,0,0,16162,6.8,17887,257,52,1766,719,25.7,1616.2,15,3,0,2,4,3,0,0,0,0,14396,6.6,17168,215,48,-1766,-719,21.5,1439.6
4521769978,0,17,2,0,4,6,2,0,0,0,0,15498,6.8,17805,228,32,-1953,-1854,22.8,1549.8,13,4,1,6,4,5,2,1,1,0,17451,7.4,19659,259,58,1953,1854,25.9,1745.1
4467280497,1,14,1,1,4,3,4,1,1,0,0,16114,7.0,18458,233,58,1694,1199,23.3,1611.4,18,0,0,3,4,3,1,0,1,0,14420,6.6,17259,210,48,-1694,-1199,21.0,1442.0
4472752313,0,9,3,0,5,6,3,0,0,0,1,17670,7.0,19067,253,56,1191,1276,25.3,1767.0,11,1,1,6,5,5,1,1,0,0,16479,6.8,17791,166,67,-1191,-1276,16.6,1647.9
4525174199,1,16,2,0,3,2,3,1,1,0,0,15356,7.0,18787,212,64,420,521,21.2,1535.6,20,4,1,2,3,1,0,0,0,0,14936,7.0,18266,230,57,-420,-521,23.0,1493.6
4519147034,0,17,2,0,7,13,11,0,0,0,0,15541,6.2,15120,180,45,-3711,-2987,18.0,1554.1,13,3,1,13,7,16,0,0,0,0,19252,7.0,18107,207,45,3711,2987,20.7,1925.2
4514596756,0,25,4,0,8,4,8,1,0,1,0,18057,7.0,18682,231,52,3152,2104,23.1,1805.7,16,2,1,4,8,4,0,0,0,0,14905,6.4,16578,211,40,-3152,-2104,21.1,1490.5
4442002416,1,18,3,0,5,2,3,0,0,0,0,16337,7.2,19371,259,48,1795,1933,25.9,1633.7,15,6,1,2,5,2,0,0,0,0,14542,6.8,17438,238,48,-1795,-1933,23.8,1454.2
4522521033,0,16,3,1,8,13,6,0,0,0,0,17705,6.8,17690,201,44,-1291,-1067,20.1,1770.5,18,4,0,13,8,16,0,0,0,0,18996,7.2,18757,213,31,1291,1067,21.3,1899.6
4500865627,0,38,4,1,3,6,3,0,0,0,0,15541,7.0,18700,236,48,-376,-71,23.6,1554.1,14,0,0,6,3,5,1,1,0,0,15917,7.0,18771,226,48,376,71,22.6,1591.7
4499865404,0,14,4,1,3,9,2,0,0,0,0,13893,6.4,15277,171,40,-4054,-3806,17.1,1389.3,18,3,0,9,3,11,2,1,1,0,17947,7.0,19083,218,80,4054,3806,21.8,1794.7
4451399633,0,16,4,1,10,7,8,0,0,0,0,18410,7.2,19835,241,54,1720,1364,24.1,1841.0,19,3,0,7,10,6,0,0,0,0,16690,7.4,18471,212,46,-1720,-1364,21.2,1669.0
4525816909,1,15,5,0,4,7,4,1,1,0,0,16526,7.0,18314,237,63,-36,-752,23.7,1652.6,16,5,1,7,4,8,0,0,0,0,16562,7.2,19066,225,60,36,752,22.5,1656.2
4515644857,1,15,3,1,8,10,5,1,1,0,0,16480,7.0,17338,183,44,-1428,-1532,18.3,1648.0,28,3,0,10,8,10,0,0,0,0,17908,7.4,18870,192,56,1428,1532,19.2,1790.8
4522165350,0,12,2,1,6,5,8,0,0,0,0,16455,7.2,18248,214,50,-614,-1330,21.4,1645.5,36,4,0,5,6,5,2,1,1,0,17069,7.4,19578,243,73,614,1330,24.3,1706.9
4525545427,1,36,0,1,3,5,2,1,1,0,0,14711,7.0,18380,209,52,-1244,-548,20.9,1471.1,11,1,0,5,3,6,1,0,1,0,15955,7.2,18928,234,51,1244,548,23.4,1595.5
4496666783,0,19,2,1,2,5,1,0,0,0,0,14321,6.4,16217,203,44,-1296,-382,20.3,1432.1,18,6,0,5,2,5,1,1,0,0,15617,6.6,16599,226,38,1296,382,22.6,1561.7
4506337812,1,41,1,1,7,3,6,1,1,0,0,18195,7.4,20319,252,64,4197,3107,25.2,1819.5,14,3,0,3,7,1,1,0,1,0,13998,6.8,17212,187,53,-4197,-3107,18.7,1399.8
4454214561,0,11,1,1,7,9,6,0,0,0,0,16248,7.0,18067,171,63,-2242,-1819,17.1,1624.8,33,2,0,9,7,12,1,1,0,0,18490,7.2,19886,229,45,2242,1819,22.9,1849.0
4523110443,1,23,1,0,7,4,8,1,0,1,1,17617,6.6,17519,199,47,241,307,19.9,1761.7,25,3,1,4,7,7,1,1,0,1,17376,6.6,17212,214,58,-241,-307,21.4,1737.6
4524954038,0,21,4,0,6,12,3,1,1,0,0,15861,6.6,17082,208,47,-3197,-1400,20.8,1586.1,15,4,1,12,6,20,0,0,0,0,19058,7.4,18482,208,48,3197,1400,20.8,1905.8
4516959176,0,18,1,0,7,8,9,0,0,0,0,15903,6.8,17263,189,40,-1831,-2604,18.9,1590.3,14,2,1,8,7,11,2,1,1,0,17734,7.2,19867,226,72,1831,2604,22.6,1773.4
4520599588,0,34,0,0,8,10,15,1,1,0,0,17134,6.8,17579,171,66,-840,949,17.1,1713.4,14,3,1,10,8,11,0,0,0,0,17974,6.8,16630,214,49,840,-949,21.4,1797.4
4527427825,1,10,9,0,9,9,6,2,1,1,0,17913,6.8,18248,217,37,785,1373,21.7,1791.3,40,3,1,9,9,15,0,0,0,0,17128,6.8,16875,191,40,-785,-1373,19.1,1712.8
4527082240,1,17,1,1,4,1,5,2,1,1,0,16973,7.2,19798,271,72,2420,2428,27.1,1697.3,12,4,0,1,4,2,0,0,0,0,14553,6.6,17370,247,48,-2420,-2428,24.7,1455.3
4520642578,1,17,6,1,2,1,1,1,0,1,0,14702,6.6,16741,244,43,649,69,24.4,1470.2,22,3,0,1,2,1,1,1,0,0,14053,6.8,16672,214,42,-649,-69,21.4,1405.3
4455082508,1,17,2,0,9,4,9,1,0,1,0,18622,7.0,18509,230,44,2962,1156,23.0,1862.2,13,2,1,4,9,6,1,1,0,0,15660,6.8,17353,181,79,-2962,-1156,18.1,1566.0
4494806155,1,21,2,1,5,1,4,0,0,0,0,16751,7.2,19355,245,53,3029,1278,24.5,1675.1,13,0,0,1,5,1,1,1,0,0,13722,6.8,18077,189,66,-3029,-1278,18.9,1372.2
4518453664,0,48,0,0,6,5,6,0,0,0,0,15904,6.8,17623,201,48,-73,217,20.1,1590.4,15,4,1,5,6,6,2,1,1,0,15977,6.6,17406,228,48,73,-217,22.8,1597.7
4474742854,0,15,4,1,6,7,2,0,0,0,0,15030,6.4,16763,204,36,-632,675,20.4,1503.0,17,4,0,7,6,8,1,1,0,0,15662,6.4,16088,192,45,632,-675,19.2,1566.2
4492353523,1,13,2,1,7,6,7,0,0,0,0,16920,7.0,17906,204,60,1563,901,20.4,1692.0,16,3,0,6,7,8,0,0,0,0,15357,6.8,17005,178,56,-1563,-901,17.8,1535.7
4463389960,0,16,3,0,3,6,3,0,0,0,0,14906,6.6,16779,195,56,-1198,-599,19.5,1490.6,17,3,1,6,3,1,0,0,0,0,16104,6.8,17378,250,44,1198,599,25.0,1610.4
4517966226,1,20,5,1,5,5,6,2,1,1,0,16746,7.2,18699,247,56,1066,-560,24.7,1674.6,42,3,0,5,5,4,0,0,0,0,15680,7.4,19259,239,47,-1066,560,23.9,1568.0
4410127520,1,17,15,0,9,3,9,0,0,0,0,18125,7.8,21102,236,48,2828,2738,23.6,1812.5,63,5,1,3,9,2,1,1,0,0,15297,7.2,18364,227,71,-2828,-2738,22.7,1529.7
4518631058,1,19,5,1,8,4,8,0,0,0,0,17041,6.8,17082,227,47,2263,1326,22.7,1704.1,19,5,0,4,8,5,1,1,0,0,14778,6.4,15756,179,55,-2263,-1326,17.9,1477.8
4515711372,0,15,0,1,5,9,3,0,0,0,0,15144,6.6,16696,205,36,-4172,-2185,20.5,1514.4,15,4,0,9,5,9,0,0,0,1,19316,7.2,18881,221,47,4172,2185,22.1,1931.6
4526615576,1,14,4,1,3,5,5,0,0,0,0,14788,6.6,16201,223,44,-166,-1446,22.3,1478.8,16,3,0,5,3,3,0,0,0,0,14954,7.0,17647,188,52,166,1446,18.8,1495.4
4480448606,1,15,3,0,10,7,8,1,0,1,0,19289,7.6,19633,240,63,2330,2319,24.0,1928.9,52,2,1,7,10,9,0,0,0,0,16959,7.0,17314,200,39,-2330,-2319,20.0,1695.9
4518477698,0,15,6,0,6,8,7,1,1,0,0,16111,6.8,17170,204,48,-1556,-1808,20.4,1611.1,15,2,1,8,6,5,0,0,0,0,17667,7.2,18978,241,40,1556,1808,24.1,1766.7
4520305649,0,14,2,0,3,8,3,0,0,0,0,14275,6.4,15474,180,56,-3414,-3747,18.0,1427.5,14,2,1,8,3,4,2,1,1,0,17689,7.2,19221,228,60,3414,3747,22.8,1768.9
4525161155,0,13,3,0,4,8,5,1,0,1,0,15577,6.6,16808,235,42,-2268,-1851,23.5,1557.7,21,3,1,8,4,7,1,1,0,0,17845,7.0,18659,239,63,2268,1851,23.9,1784.5
4495408942,1,19,3,1,11,2,20,0,0,0,0,18963,7.4,19079,239,40,5337,3334,23.9,1896.3,15,4,0,2,11,2,1,1,0,0,13626,6.6,15745,179,44,-5337,-3334,17.9,1362.6
4505844973,0,12,4,0,6,10,5,0,0,0,0,15476,6.8,16691,198,50,-2199,-2258,19.8,1547.6,38,2,1,10,6,10,1,1,0,0,17675,7.2,18949,218,48,2199,2258,21.8,1767.5
4467276496,1,36,1,1,5,5,8,0,0,0,0,16192,6.8,18197,209,60,1056,-182,20.9,1619.2,11,1,0,5,5,4,1,1,0,0,15136,7.0,18379,185,46,-1056,182,18.5,1513.6
4516926779,1,17,3,1,5,5,6,1,1,0,0,16191,7.2,18795,238,46,290,617,23.8,1619.1,15,3,0,5,5,3,0,0,0,0,15901,7.2,18178,242,44,-290,-617,24.2,1590.1
4522387396,1,16,3,1,11,11,7,1,0,1,0,18164,7.0,18492,198,52,-640,403,19.8,1816.4,12,1,0,11,11,14,1,1,0,0,18804,7.0,18089,204,50,640,-403,20.4,1880.4
4520324538,1,16,0,0,7,7,11,1,1,0,0,17162,7.2,18810,216,56,-810,123,21.6,1716.2,19,5,1,7,7,10,0,0,0,0,17972,7.2,18687,272,47,810,-123,27.2,1797.2
4490468164,1,15,5,0,4,7,4,0,0,0,0,15777,6.8,17261,229,48,-621,-784,22.9,1577.7,57,1,1,7,4,14,1,1,0,0,16398,7.0,18045,204,56,621,784,20.4,1639.8
4491980235,0,14,2,1,10,7,10,0,0,0,0,18296,7.0,18788,208,52,1011,17,20.8,1829.6,20,1,0,7,10,8,0,0,0,0,17285,7.0,18771,237,48,-1011,-17,23.7,1728.5
4515621267,0,73,4,0,3,9,4,0,0,0,0,14282,6.6,16446,182,49,-4690,-3429,18.2,1428.2,15,8,1,9,3,11,1,1,0,0,18972,7.4,19875,235,65,4690,3429,23.5,1897.2
4526755207,1,19,2,1,5,4,8,1,1,0,0,15983,6.8,17134,219,50,544,-289,21.9,1598.3,13,5,0,4,5,6,0,0,0,0,15439,6.8,17423,218,49,-544,289,21.8,1543.9
4495664229,1,48,0,1,3,7,7,0,0,0,0,14887,6.6,16190,214,48,-1725,-2004,21.4,1488.7,17,5,0,7,3,6,1,1,0,0,16612,6.8,18194,242,48,1725,2004,24.2,1661.2
4517744860,1,20,2,1,7,7,7,1,1,0,0,16636,6.8,17569,207,53,-1117,-509,20.7,1663.6,16,4,0,7,7,4,0,0,0,0,17753,7.0,18078,230,54,1117,509,23.0,1775.3
4442215686,0,20,2,1,5,5,7,0,0,0,0,16110,7.0,18673,222,53,-146,557,22.2,1611.0,15,4,0,5,5,7,0,0,0,0,16256,7.0,18116,217,64,146,-557,21.7,1625.6
4468198399,0,13,0,1,1,3,2,2,1,1,0,14675,7.0,18039,231,75,-1749,-1502,23.1,1467.5,15,3,0,3,1,2,0,0,0,0,16424,7.4,19541,264,60,1749,1502,26.4,1642.4
4494997427,0,50,2,1,4,4,4,0,0,0,0,15514,6.6,16759,223,40,249,182,22.3,1551.4,17,3,0,4,4,5,1,1,0,0,15265,6.6,16577,204,45,-249,-182,20.4,1526.5
4477234655,0,17,4,1,2,7,3,0,0,0,0,14269,6.6,16548,196,58,-2153,-1519,19.6,1426.9,16,4,0,7,2,8,0,0,0,0,16422,7.0,18067,211,39,2153,1519,21.1,1642.2
4505664040,1,14,4,1,11,2,9,0,0,0,0,19250,7.6,19703,251,48,5096,3310,25.1,1925.0,15,3,0,2,11,2,0,0,0,0,14154,6.4,16393,196,53,-5096,-3310,19.6,1415.4
4466931235,1,22,7,1,9,4,10,1,1,0,0,18132,7.0,18076,228,40,2883,2111,22.8,1813.2,21,4,0,4,9,2,0,0,0,0,15249,6.2,15965,227,36,-2883,-2111,22.7,1524.9
4512587987,0,15,2,1,3,9,3,0,0,0,0,14719,6.6,16608,195,52,-3485,-2423,19.5,1471.9,37,3,0,9,3,12,1,1,0,0,18204,7.2,19031,237,50,3485,2423,23.7,1820.4
4496547749,1,13,3,1,8,9,8,2,1,1,0,17267,7.0,17580,203,51,-356,-408,20.3,1726.7,48,3,0,9,8,16,0,0,0,0,17623,6.8,17988,180,44,356,408,18.0,1762.3
4519268347,0,14,0,0,2,3,3,1,0,1,1,16664,6.8,18036,255,55,1047,-143,25.5,1666.4,14,3,1,3,2,4,1,1,0,0,15617,7.0,18179,247,54,-1047,143,24.7,1561.7
4446790862,0,14,3,0,4,3,2,0,0,0,0,15744,7.6,20593,234,67,419,1790,23.4,1574.4,16,2,1,3,4,0,1,1,0,0,15325,7.2,18803,263,52,-419,-1790,26.3,1532.5
4519427485,0,24,4,1,6,4,8,0,0,0,0,16505,6.8,17567,205,52,805,149,20.5,1650.5,13,8,0,4,6,4,1,1,0,0,15700,7.0,17418,256,44,-805,-149,25.6,1570.0
4522561203,0,35,3,1,5,4,4,1,0,1,0,16384,7.4,18938,244,50,-183,254,24.4,1638.4,16,5,0,4,5,3,1,1,0,0,16567,7.0,18684,243,60,183,-254,24.3,1656.7
4450459916,0,14,3,1,6,12,7,1,1,0,0,16043,7.0,17409,220,51,-3089,-2946,22.0,1604.3,20,4,0,12,6,12,0,0,0,0,19132,7.6,20355,235,50,3089,2946,23.5,1913.2
4520614992,0,14,2,0,4,12,4,0,0,0,0,14920,6.8,17398,186,57,-6000,-3856,18.6,1492.0,16,4,1,12,4,15,1,1,0,0,20920,7.6,21254,246,60,6000,3856,24.6,2092.0
4449290727,0,15,2,0,5,4,6,0,0,0,0,16485,7.2,18714,247,48,577,1501,24.7,1648.5,15,1,1,4,5,5,1,1,0,0,15908,6.8,17213,236,56,-577,-1501,23.6,1590.8
4477615327,0,15,2,1,7,4,10,2,1,1,0,17256,7.0,18265,228,64,1177,226,22.8,1725.6,14,1,0,4,7,6,0,0,0,0,16079,6.8,18039,217,51,-1177,-226,21.7,1607.9
4523400040,1,15,3,0,7,4,14,0,0,0,0,16865,6.8,17583,211,59,1897,1014,21.1,1686.5,13,3,1,4,7,5,0,0,0,0,14968,6.6,16569,182,28,-1897,-1014,18.2,1496.8
4523696498,1,19,2,0,4,6,4,1,0,1,0,15578,6.8,17702,229,46,-1018,-1124,22.9,1557.8,20,2,1,6,4,6,0,0,0,0,16596,7.0,18826,240,51,1018,1124,24.0,1659.6
4524910590,0,12,2,0,5,8,7,0,0,0,0,15513,6.6,17308,203,43,-1791,507,20.3,1551.3,11,0,1,8,5,14,2,1,1,0,17304,6.8,16801,225,41,1791,-507,22.5,1730.4
4524799428,1,40,1,1,9,3,7,0,0,0,0,18322,7.4,20963,258,68,4100,4903,25.8,1832.2,38,11,0,3,9,1,0,0,0,0,14222,6.4,16060,204,41,-4100,-4903,20.4,1422.2
4521152732,0,14,0,0,5,9,3,0,0,0,0,14964,6.6,17465,196,48,-3225,-1705,19.6,1496.4,15,0,1,9,5,6,2,1,1,0,18189,7.4,19170,249,67,3225,1705,24.9,1818.9
4467510471,0,13,2,0,5,10,7,0,0,0,0,16161,6.8,16954,213,53,-3761,-2475,21.3,1616.1,16,3,1,10,5,13,2,1,1,1,19922,7.2,19429,241,52,3761,2475,24.1,1992.2
4515654011,1,16,2,1,4,8,3,1,1,0,0,15672,7.2,17821,238,47,-1599,-1870,23.8,1567.2,21,1,0,8,4,9,1,0,1,0,17271,7.4,19691,236,48,1599,1870,23.6,1727.1
4463214221,0,20,1,0,5,5,10,1,1,0,0,15847,6.8,17480,203,68,-1015,-1395,20.3,1584.7,13,6,1,5,5,9,1,0,1,0,16862,7.2,18875,256,52,1015,1395,25.6,1686.2
4521483085,1,16,4,1,6,3,6,1,1,0,0,17536,7.0,19253,266,48,2880,2785,26.6,1753.6,58,2,0,3,6,5,0,0,0,0,14656,6.6,16468,197,48,-2880,-2785,19.7,1465.6
4507030336,0,20,2,1,6,9,7,0,0,0,0,17430,6.8,18068,212,63,-367,187,21.2,1743.0,15,3,0,9,6,9,0,0,0,0,17797,7.2,17881,205,60,367,-187,20.5,1779.7
4525129730,0,12,2,0,1,9,2,0,0,0,0,13299,6.4,15911,189,48,-7285,-4379,18.9,1329.9,15,2,1,9,1,17,1,1,0,1,20584,7.6,20290,251,60,7285,4379,25.1,2058.4
4487326778,0,15,3,0,3,11,3,0,0,0,0,14579,6.6,15951,227,35,-3603,-3793,22.7,1457.9,16,3,1,11,3,9,0,0,0,0,18182,7.2,19744,232,49,3603,3793,23.2,1818.2
4527036536,1,81,2,0,7,6,9,0,0,0,0,15685,6.6,16091,179,34,-817,-968,17.9,1568.5,16,2,1,6,7,9,0,0,0,0,16502,6.6,17059,209,45,817,968,20.9,1650.2
4523093613,1,17,3,0,5,7,3,1,1,0,0,16056,6.8,17578,234,56,-1419,-1156,23.4,1605.6,39,2,1,7,5,13,1,0,1,0,17475,7.0,18734,227,52,1419,1156,22.7,1747.5
4435256740,0,14,5,1,7,4,5,1,1,0,0,17030,7.2,19832,250,49,1207,1638,25.0,1703.0,39,3,0,4,7,8,0,0,0,0,15823,7.0,18194,234,46,-1207,-1638,23.4,1582.3
4489494920,0,13,0,0,2,9,4,0,0,0,0,13916,6.2,15087,166,49,-6286,-4733,16.6,1391.6,34,1,1,9,2,8,2,1,1,1,20202,7.6,19820,259,58,6286,4733,25.9,2020.2
4515347067,1,59,1,1,5,2,3,1,0,1,0,16014,7.0,18969,225,58,476,467,22.5,1601.4,21,6,0,2,5,1,0,0,0,0,15538,7.2,18502,257,53,-476,-467,25.7,1553.8
4437580789,0,16,5,0,5,6,4,0,0,0,0,16258,7.0,18533,255,47,585,570,25.5,1625.8,39,3,1,6,5,9,0,0,0,0,15673,6.8,17963,180,52,-585,-570,18.0,1567.3
4513670045,0,16,3,0,4,4,6,0,0,0,0,15641,7.2,17857,244,40,-1136,-1235,24.4,1564.1,61,2,1,4,4,3,1,1,0,0,16777,7.2,19092,234,71,1136,1235,23.4,1677.7
4521615656,1,14,0,0,7,4,4,1,1,0,0,16775,7.0,18235,221,55,1753,2303,22.1,1677.5,19,3,1,4,7,7,0,0,0,0,15022,6.4,15932,213,45,-1753,-2303,21.3,1502.2
